Values,Weights,Number of Items, Capacity,Value that Greedy Put in Bag,Value that DP Put in Bag,Greedy Solution,DP Solution,Error of Greedy
"15,26,9,15,29,14,2,13,4,7","16,20,6,10,24,25,2,19,3,7",10,100,107,113,"1111101011","1111101110",6
"4,22,11,12,20,2,16,6,29,8","4,15,13,11,13,1,23,6,20,6",10,100,114,119,"1111110111","1101111111",5
"20,26,16,8,3,7,33,21,24,3","17,23,12,6,2,7,24,21,16,2",10,100,114,130,"1011111011","1111001011",16
"20,26,12,4,16,5,10,7,7,9","13,20,17,4,12,5,14,7,7,6",10,100,104,111,"1101111111","1111101111",7
"6,4,23,25,16,18,4,25,4,8","6,4,18,23,23,23,4,23,4,6",10,100,99,105,"1111001111","1011010101",6
"5,1,16,5,6,21,29,19,24,16","3,1,15,5,7,21,22,17,17,19",10,100,105,119,"1111101110","1011011110",14
"1,6,16,8,16,8,12,20,16,4","1,8,15,9,22,13,17,13,12,4",10,100,95,98,"1111110111","0111101111",3
"16,29,7,22,5,26,8,29,14,25","19,21,8,16,5,20,6,21,10,23",10,100,133,133,"0101111110","0101111110",0
"1,6,30,20,23,6,34,16,23,8","1,8,21,13,18,8,25,23,18,6",10,100,128,131,"1111111001","1011101010",3
"3,24,30,31,17,16,1,10,34,8","2,17,20,21,17,22,1,14,25,8",10,100,131,136,"1111001011","0111100010",5
"7,17,12,18,16,33,19,2,7,22","11,25,11,25,21,24,17,2,8,16",10,100,111,111,"0010111111","0010111111",0
"1,24,31,14,10,2,10,8,18,4","1,17,21,15,7,2,14,6,25,4",10,100,112,112,"1111110111","1111110111",0
"6,6,8,7,16,16,31,2,16,29","6,8,14,7,12,22,21,1,19,23",10,100,113,113,"1101101111","1101101111",0
"19,8,7,21,8,14,26,1,5,8","14,8,8,18,13,10,20,1,3,14",10,100,109,109,"1111111110","1111011111",0
"6,2,11,6,30,29,25,7,14,11","11,1,15,7,25,23,23,7,25,13",10,100,110,110,"0101111101","0101111101",0
"6,8,8,29,6,33,29,8,7,21","8,6,8,23,5,24,23,13,7,18",10,100,126,126,"0101111001","0101111001",0
"20,29,13,18,22,24,2,18,30,15","13,21,13,25,15,17,1,23,20,16",10,100,140,140,"1110111010","1110111010",0
"4,11,9,11,1,3,5,6,29,8","4,13,6,12,1,2,3,6,21,8",10,100,87,87,"1111111111","1111111111",0
"18,18,3,7,29,30,31,29,19,4","19,23,2,8,23,25,21,22,17,4",10,100,126,126,"0010111101","0010111101",0
"22,8,31,2,16,1,7,6,12,24","15,11,21,2,21,1,7,8,11,17",10,100,115,118,"1011111011","1010101111",3
"20,22,29,31,18,6,8,30,17,17","13,16,21,21,15,5,13,20,25,25",10,100,138,138,"1111010100","1111010100",0
"14,15,5,29,18,1,5,6,8,24","10,16,5,20,23,1,5,8,9,17",10,100,107,113,"1111011111","1101101011",6
"8,6,29,2,8,6,2,18,16,12","8,8,21,1,6,8,1,25,21,11",10,100,89,97,"1111111011","1010110111",8
"22,4,21,22,7,15,34,8,8,9","16,4,18,15,7,16,25,8,13,6",10,100,127,127,"1111101101","1111101101",0
"20,29,29,29,14,8,19,19,34,16","17,24,20,24,10,11,17,14,25,15",10,100,125,131,"0110100110","1011000110",6
"14,18,2,15,13,33,29,7,17,30","10,23,1,16,18,24,24,7,17,25",10,100,115,123,"1010011101","1000011011",8
"2,26,12,2,19,20,1,13,24,25","1,20,17,1,14,15,1,18,17,23",10,100,119,119,"1101111011","1101111011",0
"23,6,29,16,16,29,8,18,5,21","18,6,21,12,15,22,8,25,5,21",10,100,124,124,"1111110010","1111010001",0
"20,8,10,2,8,26,30,5,23,16","17,13,14,1,13,23,20,5,17,15",10,100,122,122,"1001011111","1001011111",0
"5,4,11,2,2,18,2,3,25,7","5,3,12,1,1,25,1,2,23,7",10,100,79,79,"1111111111","1111111111",0
"29,4,26,8,16,20,4,17,22,20","24,4,23,9,21,15,3,17,16,17",10,100,121,121,"1010011011","1010011011",0
"6,24,12,29,5,4,2,15,14,13","7,17,17,21,3,3,1,16,25,19",10,100,97,104,"1111111100","0111111101",7
"18,18,22,7,2,2,7,5,24,1","25,15,15,7,2,1,7,5,17,1",10,100,106,106,"1111111111","1111111111",0
"6,4,24,23,8,18,17,6,16,13","7,3,17,18,8,25,17,7,22,19",10,100,104,104,"1111101110","1111101110",0
"22,20,22,16,2,14,16,9,26,4","16,15,15,23,1,25,12,6,23,3",10,100,121,121,"1110101111","1110101111",0
"6,11,29,31,17,18,4,29,20,23","8,12,22,21,25,23,4,23,17,17",10,100,132,132,"0011000111","0011000111",0
"8,15,18,16,20,31,11,16,1,18","14,10,12,22,13,21,15,21,1,25",10,100,112,117,"0110111110","0111110110",5
"8,21,4,16,6,21,13,22,7,18","6,18,4,15,8,21,19,16,11,25",10,100,105,105,"1111110110","1111110110",0
"30,16,16,9,24,9,7,2,25,8","21,22,19,6,17,6,7,1,23,13",10,100,122,122,"1011111110","1011111110",0
"8,11,29,16,29,14,14,8,1,7","6,13,24,23,20,10,25,6,1,7",10,100,107,112,"1110110111","1011110111",5
"20,18,8,4,21,24,17,29,18,15","13,19,11,3,21,17,25,21,15,16",10,100,116,121,"1001110110","1111010110",5
"24,33,20,11,4,18,22,16,14,7","16,24,15,15,3,23,15,12,10,7",10,100,133,136,"1110101110","1110001111",3
"14,8,18,16,2,10,26,11,29,16","10,13,23,21,1,14,20,15,21,21",10,100,105,105,"1011101010","1100111011",0
"6,16,6,19,16,13,8,11,21,8","8,22,7,17,21,13,6,13,18,13",10,100,94,94,"0011111110","0011111110",0
"30,7,18,5,8,7,5,30,16,18","20,11,19,3,13,8,5,25,21,25",10,100,102,108,"1111011100","1011010101",6
"30,1,29,18,26,25,26,1,16,16","25,1,24,12,23,23,20,1,21,19",10,100,105,119,"1111001100","1011001001",14
"8,18,1,18,8,15,33,4,24,8","8,23,1,23,14,10,24,4,17,8",10,100,111,111,"1110011111","1011011111",0
"5,14,8,16,6,25,18,30,5,21","5,10,6,23,7,23,25,21,5,18",10,100,114,114,"1110110111","1110110111",0
"16,1,1,26,29,2,18,4,29,26","15,1,1,20,21,1,25,3,24,23",10,100,118,118,"0111110111","0111110111",0
"18,22,14,6,6,8,6,8,5,29","19,16,10,8,7,6,8,9,5,20",10,100,116,116,"1111110111","1110111111",0
"34,19,6,16,6,1,8,5,2,4","25,14,5,15,8,1,13,5,1,3",10,100,101,101,"1111111111","1111111111",0
"16,12,4,21,13,12,30,17,7,4","19,11,4,21,13,11,21,17,7,3",10,100,103,109,"0111111011","0101111101",6
"4,17,19,19,14,6,7,10,1,14","3,25,17,14,15,6,7,7,1,25",10,100,97,97,"1111111110","1111111110",0
"14,14,16,8,17,7,14,7,8,16","25,25,19,13,25,11,10,7,13,15",10,100,85,85,"0011111101","0010111111",0
"19,10,16,14,9,8,1,18,12,3","17,7,19,10,6,13,1,12,17,2",10,100,102,102,"1111101111","1111101111",0
"16,18,29,22,5,16,18,2,18,29","15,23,23,16,5,19,23,1,19,22",10,100,103,119,"1011100101","1011100011",16
"4,34,16,6,26,18,29,15,18,16","4,25,15,6,23,23,22,16,25,15",10,100,121,121,"0110101001","0110101001",0
"2,5,3,29,22,18,17,8,4,6","1,5,2,24,16,23,25,6,4,8",10,100,97,101,"1111110111","0011111110",4
"16,5,29,8,18,7,6,5,8,8","22,5,20,6,12,7,7,3,11,13",10,100,102,104,"1111111110","1111110111",2
"18,8,10,2,34,4,26,13,34,15","12,11,7,1,25,3,20,13,25,16",10,100,128,131,"1011111010","1001111110",3
"21,16,18,4,29,4,8,14,31,3","21,21,23,3,22,3,14,10,21,2",10,100,114,118,"1001111111","1100110111",4
"30,2,8,14,34,16,8,24,17,7","20,1,14,10,25,12,6,16,17,7",10,100,135,135,"1101111101","1101111101",0
"1,8,22,29,8,4,30,7,18,14","1,8,15,21,6,3,21,11,23,25",10,100,120,120,"1111111010","1111111010",0
"8,4,8,16,19,8,2,16,4,8","6,3,13,15,17,6,1,15,3,6",10,100,93,93,"1111111111","1111111111",0
"29,4,8,16,23,1,8,18,16,15","20,3,9,23,17,1,13,19,22,10",10,100,106,113,"1110111101","1110100111",7
"6,7,13,15,6,15,5,8,2,1","11,8,18,10,11,16,5,8,1,1",10,100,78,78,"1111111111","1111111111",0
"9,6,18,4,2,21,7,6,19,7","6,6,15,3,1,18,7,5,14,11",10,100,99,99,"1111111111","1111111111",0
"29,2,12,20,22,6,13,20,14,18","20,2,17,13,16,11,19,17,10,25",10,100,119,120,"1111100110","1101101110",1
"11,6,10,18,11,18,10,2,20,33","13,5,7,25,15,23,14,1,15,24",10,100,100,107,"1110010111","0111010111",7
"10,24,21,10,18,18,16,17,26,12","14,16,21,14,15,25,15,17,20,11",10,100,117,118,"0110101011","0110100111",1
"2,18,3,6,31,4,3,10,29,16","1,23,2,7,21,3,2,7,20,22",10,100,106,114,"1111111110","0110111111",8
"29,33,20,10,8,10,5,18,22,29","23,24,15,7,8,7,5,15,16,21",10,100,132,133,"0111110011","1101010011",1
"6,5,24,12,23,33,4,1,7,14","8,5,17,11,18,24,4,1,7,10",10,100,123,124,"0111111111","1011111111",1
"18,7,24,30,8,6,6,5,30,16","12,7,17,21,8,7,11,3,20,19",10,100,128,131,"1111110110","1011100111",3
"25,17,12,26,19,13,13,16,20,17","23,17,11,23,17,13,18,12,13,17",10,100,118,118,"1011100110","1011100110",0
"4,29,8,8,22,29,22,17,25,1","3,22,6,6,16,22,15,17,23,1",10,100,123,128,"1111111001","0100111011",5
"26,11,4,18,8,22,31,6,20,29","20,13,4,15,14,15,21,8,17,20",10,100,130,132,"1011011001","1010011011",2
"25,19,10,6,10,8,2,1,22,16","23,14,14,11,14,9,2,1,15,12",10,100,103,108,"1110011111","1101111011",5
"30,11,16,14,1,1,16,14,20,4","25,13,21,25,1,1,19,25,13,3",10,100,99,99,"1110111011","1110111011",0
"20,23,2,31,1,24,23,6,3,7","15,17,1,21,1,16,17,8,2,7",10,100,134,134,"1111111011","1111111011",0
"16,7,20,6,33,1,5,29,1,30","22,8,17,8,24,1,5,23,1,20",10,100,126,126,"0110111111","0110111111",0
"30,19,8,7,8,1,18,26,6,13","21,14,6,8,8,1,19,20,6,13",10,100,118,121,"1111110111","1110011111",3
"6,30,29,30,3,6,26,17,13,8","8,25,24,20,2,5,20,17,19,14",10,100,124,124,"0111111000","0111111000",0
"18,11,16,4,11,4,1,30,20,14","23,15,22,3,12,3,1,21,15,25",10,100,99,104,"1101111110","1011111110",5
"1,6,6,1,6,12,6,11,14,1","1,11,6,1,6,11,8,12,25,1",10,100,64,64,"1111111111","1111111111",0
"7,8,18,34,16,23,12,17,18,6","7,6,12,25,22,18,11,25,23,7",10,100,108,114,"1111011001","1111010011",6
"17,13,5,18,14,13,29,16,26,22","17,18,5,12,25,18,24,15,20,16",10,100,116,117,"0011001111","1011001011",1
"16,1,14,24,10,1,14,29,6,2","22,1,10,17,7,1,10,20,8,1",10,100,117,117,"1111111111","1111111111",0
"7,12,11,8,11,3,16,18,18,3","7,17,15,8,15,2,23,23,25,2",10,100,79,80,"1011110111","1101110111",1
"8,2,29,33,30,1,29,24,6,20","8,1,23,24,25,1,22,17,8,15",10,100,123,127,"1101011111","1101111100",4
"12,22,24,29,13,14,6,30,16,2","17,16,16,23,19,10,6,25,15,1",10,100,127,127,"0111011101","0111011101",0
"25,30,6,6,10,6,3,21,18,10","23,20,8,7,7,8,2,21,19,7",10,100,117,117,"1100101111","1100101111",0
"16,23,8,30,19,24,8,21,18,10","21,17,6,20,17,16,6,18,15,14",10,100,132,133,"0111011110","0111111100",1
"31,8,16,18,11,23,17,30,6,8","21,13,22,23,15,17,25,21,11,9",10,100,110,113,"1001010101","1001110100",3
"7,30,8,16,11,7,6,2,21,13","8,21,11,22,15,7,7,1,21,13",10,100,97,102,"1100111111","1101011111",5
"3,6,16,3,10,4,12,1,4,8","2,7,15,2,7,4,11,1,3,6",10,100,67,67,"1111111111","1111111111",0
"4,25,20,5,8,5,24,8,18,5","4,23,17,5,8,3,17,13,15,3",10,100,114,114,"1111111011","1111011111",0
"11,20,18,15,8,13,30,9,7,15","12,15,25,16,14,18,21,6,7,10",10,100,107,114,"1101001111","0111001111",7
"4,22,19,29,1,29,23,24,6,30","4,16,17,24,1,24,18,16,6,21",10,100,133,133,"1101101101","1100111101",0
"12,7,14,24,16,18,18,16,8,8","17,11,10,17,23,25,25,12,14,13",10,100,97,97,"0111011100","0111011100",0
"16,14,7,6,33,8,9,11,18,8","15,10,11,6,24,6,6,13,23,13",10,100,104,109,"1111111100","1100111110",5
"4,29,10,2,13,19,6,13,13,16","4,21,7,1,18,14,8,18,18,15",10,100,99,106,"1111111001","1111010111",7
"19,8,10,10,8,18,19,20,9,3","17,6,14,14,9,23,17,17,6,2",10,100,104,104,"1100111111","1100111111",0
"4,11,15,18,21,3,6,29,30,3","3,13,16,12,18,2,7,20,20,2",10,100,129,129,"1011111111","1011111111",0
"20,4,3,19,7,20,25,8,3,6","15,4,2,17,7,13,23,11,2,11",10,100,109,109,"1111111110","1111111110",0
"4,2,16,3,2,16,11,16,11,4","4,1,15,2,1,15,15,22,15,3",10,100,85,85,"1111111111","1111111111",0
"17,16,14,24,4,18,29,29,15,4","25,15,15,17,4,25,20,24,10,4",10,100,121,121,"0101101111","0101101111",0
"24,12,24,13,13,4,26,12,11,2","16,11,16,13,18,3,23,17,13,2",10,100,116,116,"1111011011","1111011011",0
"8,16,13,8,16,19,16,18,16,16","6,21,13,13,22,14,15,19,21,15",10,100,98,98,"1011011101","0010011111",0
"4,16,24,6,12,8,18,24,29,14","3,15,17,8,17,11,15,17,21,10",10,100,129,129,"1110001111","1110001111",0
"16,25,18,2,1,33,1,5,22,11","15,23,19,1,1,24,1,5,16,12",10,100,116,118,"1101111111","1111111010",2
"4,12,18,30,8,24,6,3,31,4","4,11,25,21,13,17,8,2,21,4",10,100,114,119,"1101011111","1101111011",5
"6,6,18,21,6,3,12,20,6,2","7,11,15,21,11,2,17,13,8,1",10,100,94,94,"1111011111","0111111111",0
"12,31,3,7,33,11,7,4,6,17","17,21,2,11,24,13,7,3,5,17",10,100,112,115,"0110111111","0111111011",3
"13,16,7,6,16,22,1,30,30,33","13,12,7,8,22,15,1,20,25,24",10,100,132,132,"0100011111","0100011111",0
"29,21,4,9,23,16,9,14,16,11","24,18,4,6,17,19,6,15,23,13",10,100,109,116,"1111101100","1101101101",7
"16,31,7,6,2,9,29,30,7,18","23,21,11,5,2,6,23,20,7,15",10,100,132,132,"0101111111","0101111111",0
"18,13,6,2,16,11,29,1,1,17","19,19,5,1,15,15,23,1,1,17",10,100,101,102,"1011111111","1111101011",1
"23,20,29,13,8,6,29,18,22,18","17,13,23,13,6,8,23,12,15,23",10,100,133,133,"1111100110","1101101110",0
"10,14,23,23,7,8,23,16,21,16","7,15,17,17,8,6,17,22,18,23",10,100,122,122,"1111011010","1111011010",0
"22,24,14,14,18,6,2,23,5,17","15,16,25,25,23,5,1,18,5,25",10,100,100,106,"1100111110","1100101101",6
"16,6,8,16,29,6,11,2,34,14","15,5,13,23,22,7,15,2,25,10",10,100,115,116,"1110110111","1100111011",1
"10,10,4,33,30,16,23,8,20,23","14,14,4,24,25,19,17,13,17,17",10,100,129,129,"0001101011","0001101011",0
"11,24,16,3,8,3,26,31,17,26","13,17,23,2,6,2,20,21,25,20",10,100,121,129,"0101111101","1100111101",8
"23,15,31,22,17,18,3,7,16,14","17,10,21,16,17,25,2,11,19,15",10,100,125,125,"1111101001","1111101001",0
"29,19,6,14,23,4,18,11,34,14","20,14,6,10,17,3,25,15,25,15",10,100,129,129,"1111110010","1110110011",0
"16,6,6,2,19,7,7,6,17,20","23,7,8,1,14,7,7,7,25,13",10,100,89,94,"1111111101","1001111111",5
"13,16,18,6,30,29,15,19,14,29","18,23,15,6,21,21,10,14,10,24",10,100,136,136,"0000111111","0000111111",0
"29,29,6,11,10,14,12,7,29,6","24,23,6,15,14,10,11,7,23,11",10,100,119,120,"1110011010","1100011110",1
"29,6,8,6,3,8,14,33,2,24","20,8,14,7,2,11,10,24,1,17",10,100,125,125,"1101111111","1101111111",0
"2,6,7,7,8,7,30,15,29,2","1,11,7,11,11,7,21,16,22,2",10,100,107,107,"1011111111","1011111111",0
"30,21,29,8,6,7,16,30,8,6","25,21,24,13,5,8,23,21,8,5",10,100,116,118,"1010110111","1110000110",2
"1,12,17,9,7,2,25,16,24,25","1,11,17,6,7,1,23,22,17,23",10,100,115,115,"1111011011","1111011011",0
"18,4,24,6,6,25,16,2,6,14","23,4,17,8,8,23,19,1,8,25",10,100,95,97,"1111011100","1010111110",2
"30,11,11,11,16,8,8,19,4,4","25,15,15,15,15,11,6,17,4,4",10,100,100,100,"1100111111","1001111111",0
"33,31,7,8,18,2,23,11,24,16","24,21,7,13,15,1,17,12,17,23",10,100,131,131,"1100111010","1110011110",0
"7,10,4,25,2,10,6,18,13,4","7,7,3,23,2,14,8,15,19,4",10,100,86,97,"1111111101","1111011111",11
"8,21,20,2,29,2,1,24,12,13","8,18,17,2,24,1,1,16,11,18",10,100,119,119,"1111111110","1111111110",0
"15,4,26,16,13,10,11,6,30,30","16,3,20,21,19,14,12,8,25,25",10,100,111,112,"1110000111","1010001011",1
"19,31,26,25,4,17,11,19,16,1","17,21,20,23,3,17,12,14,21,1",10,100,125,125,"1111100101","1111100101",0
"29,30,34,5,4,6,2,21,1,18","23,25,25,5,4,7,1,18,1,15",10,100,123,123,"1111101011","1111101011",0
"21,4,1,16,16,22,2,18,6,23","18,4,1,15,12,16,1,12,8,17",10,100,123,125,"1111111101","1011111111",2
"3,2,8,14,12,15,25,29,18,6","2,2,13,25,17,10,23,22,23,6",10,100,98,104,"1100011111","1010011111",6
"20,34,4,3,18,20,18,16,30,1","17,25,3,2,25,15,25,22,25,1",10,100,112,112,"1111010011","1111010011",0
"24,1,30,16,13,24,24,14,21,14","16,1,21,19,18,16,16,10,18,10",10,100,131,138,"1110011101","1110011011",7
"16,14,18,17,11,18,16,30,3,24","15,15,19,25,12,19,22,20,2,16",10,100,109,116,"1010010111","1100110111",7
"8,29,24,24,22,30,4,11,2,29","9,21,17,17,15,21,3,13,1,22",10,100,135,140,"0111111010","0101111011",5
"15,21,16,6,29,14,7,3,20,9","10,21,21,5,23,15,7,2,13,6",10,100,110,121,"1101101111","1101111011",11
"8,20,18,33,15,16,16,20,21,29","13,13,23,24,10,22,22,17,18,22",10,100,125,126,"1101100101","1101100011",1
"5,29,7,26,15,6,5,23,16,21","5,21,7,20,16,11,5,17,15,18",10,100,120,122,"1101000111","0111000111",2
"6,23,13,2,2,24,8,17,29,3","8,18,19,1,1,17,6,17,24,2",10,100,114,114,"1101111111","1101111111",0
"6,8,6,29,4,1,20,31,16,5","8,6,8,23,4,1,13,21,12,3",10,100,126,126,"1111111111","1111111111",0
"6,1,19,22,6,29,1,7,29,8","6,1,14,15,8,24,1,7,21,9",10,100,122,122,"1111011111","0111111111",0
"6,12,8,22,2,6,10,18,16,30","6,11,6,15,2,8,7,25,15,20",10,100,112,116,"1111111011","0111001111",4
"29,20,6,8,2,7,33,7,19,6","24,15,11,13,1,7,24,8,14,5",10,100,123,123,"1100111111","1100111111",0
"26,18,29,7,16,4,24,26,13,29","20,15,24,11,21,4,17,20,19,20",10,100,127,130,"1100011101","0110011101",3
"4,31,3,14,6,21,16,5,1,10","3,21,2,25,11,18,21,3,1,14",10,100,97,97,"1110111111","1110111111",0
"3,13,29,18,18,2,8,2,1,8","2,19,23,23,15,2,9,1,1,14",10,100,94,94,"1111111110","1111110111",0
"29,6,14,8,16,1,6,11,16,22","23,8,25,8,12,1,11,12,15,16",10,100,109,109,"1101110111","1001111111",0
"16,17,6,19,23,4,25,8,16,16","12,17,8,17,17,3,23,11,15,22",10,100,109,112,"1011111010","1101111100",3
"30,8,14,29,1,3,21,8,30,21","25,13,10,21,1,2,18,6,20,18",10,100,123,132,"1111110110","1011000111",9
"1,14,20,29,12,7,16,34,1,2","1,10,13,20,17,11,23,25,1,1",10,100,120,120,"1111110111","1111110111",0
"13,10,30,2,30,29,1,8,18,4","18,7,20,1,21,22,1,6,25,4",10,100,127,127,"1111111101","1111111101",0
"30,17,31,30,29,18,20,14,8,30","25,25,21,25,21,23,13,15,14,20",10,100,140,140,"1010101001","0011101001",0
"4,16,4,7,7,20,30,19,17,29","4,23,3,8,7,15,21,14,25,21",10,100,120,120,"1011111101","1011111101",0
"30,23,26,14,1,21,6,14,18,12","20,17,20,15,1,21,8,25,25,11",10,100,119,119,"1110111001","1110111001",0
"3,7,30,14,13,2,5,29,19,19","2,8,25,10,19,1,3,22,17,14",10,100,121,125,"1011011111","0111011111",4
"2,29,9,34,7,4,18,7,5,6","1,20,6,25,7,4,19,11,3,6",10,100,114,117,"1111111011","1111101111",3
"8,6,2,11,14,24,24,8,16,18","13,8,1,15,15,17,17,9,22,15",10,100,107,107,"0111111101","0111111101",0
"3,31,14,18,29,18,4,7,11,6","2,21,25,15,24,19,4,7,15,5",10,100,116,116,"1101111101","1101111101",0
"29,10,11,18,16,7,13,14,26,33","21,7,15,15,15,7,18,10,20,24",10,100,130,130,"1101000111","1101000111",0
"6,2,18,2,8,2,12,6,20,14","8,1,23,1,14,1,11,6,17,10",10,100,90,90,"1111111111","1111111111",0
"19,12,8,34,10,10,16,24,8,7","14,17,14,25,14,7,19,16,6,7",10,100,118,118,"1001011111","1001011111",0
"3,17,15,6,12,24,16,16,23,16","2,17,16,11,17,17,19,21,18,12",10,100,110,111,"1110110011","0110011011",1
"24,4,8,18,22,2,2,18,13,24","16,3,8,25,16,2,1,25,18,17",10,100,99,109,"1110111011","1100111111",10
"14,2,26,19,7,8,5,29,18,26","10,1,20,14,7,11,3,23,25,23",10,100,121,126,"1111001101","1011101101",5
"6,5,33,16,5,15,15,10,6,17","8,5,24,15,5,10,16,14,8,17",10,100,112,112,"1111111001","0111111011",0
"1,22,30,16,11,4,10,8,6,2","1,15,25,15,13,4,14,13,8,1",10,100,102,103,"1111111011","0111111101",1
"13,14,18,24,14,16,13,18,8,11","13,25,23,17,10,22,18,23,6,15",10,100,95,96,"1011100110","1001110101",1
"10,15,6,4,29,1,20,1,8,24","14,16,8,3,23,1,13,1,13,16",10,100,110,112,"1111111101","1101111111",2
"24,18,29,16,16,23,2,6,7,19","17,25,20,22,19,18,1,8,7,14",10,100,120,120,"1010111011","1010111011",0
"8,8,20,24,8,9,29,30,9,26","6,8,15,17,8,6,22,20,6,20",10,100,137,138,"1111011110","0011001111",1
"16,26,6,16,14,2,20,18,16,16","19,20,8,15,25,1,15,23,15,19",10,100,102,104,"1111011010","0111011110",2
"8,22,1,7,8,14,8,30,14,29","6,15,1,7,6,10,9,21,25,24",10,100,127,127,"1111111101","1111111101",0
"2,2,18,20,20,34,29,13,7,4","1,2,25,13,13,25,20,13,11,4",10,100,124,129,"1101111101","1001111111",5
"1,16,14,24,24,18,10,29,4,8","1,23,10,17,16,25,7,23,4,11",10,100,114,121,"1011101111","0111101110",7
"30,12,26,26,14,6,2,5,30,16","21,11,23,20,10,8,2,5,21,19",10,100,128,131,"1011101010","1011100110",3
"14,7,17,24,5,19,17,10,11,8","15,8,25,17,5,14,17,7,12,9",10,100,108,110,"1001111111","1101011111",2
"2,11,8,29,7,18,11,3,8,13","1,13,6,21,8,15,15,2,8,18",10,100,97,103,"1111111110","1111011111",6
"30,22,10,6,14,16,26,29,16,4","25,15,14,8,10,21,23,24,15,3",10,100,125,125,"1100101101","1100101101",0
"4,7,7,11,2,1,23,6,16,14","3,8,7,12,2,1,18,6,12,10",10,100,91,91,"1111111111","1111111111",0
"16,34,6,22,33,7,16,22,2,14","21,25,5,15,24,11,19,16,1,10",10,100,133,133,"0111100111","0111100111",0
"1,29,1,6,33,17,9,6,24,15","1,21,1,8,24,17,6,5,17,16",10,100,126,126,"1111111110","1111111110",0
"12,30,22,4,16,16,18,23,2,13","17,25,16,3,12,21,23,17,2,19",10,100,115,115,"0111101110","0111101110",0
"20,29,13,17,14,7,14,33,7,5","15,20,13,17,10,7,25,24,11,5",10,100,126,126,"1111100100","1111100100",0
"24,6,11,31,30,18,18,6,15,1","16,6,12,21,21,19,15,7,10,1",10,100,131,131,"1101101111","1101101111",0
"2,16,8,5,24,10,6,15,18,2","1,23,6,3,16,7,11,10,23,1",10,100,100,104,"1111110111","0111111111",4
"20,13,18,29,13,8,16,1,22,29","17,19,19,20,19,9,23,1,15,20",10,100,119,126,"1011000111","1011010011",7
"1,6,16,11,16,16,13,18,20,15","1,5,15,15,15,22,13,23,13,16",10,100,98,104,"1111101011","0110101111",6
"16,16,6,21,8,16,6,8,7,8","22,22,8,21,6,23,8,14,7,8",10,100,80,84,"1011101111","1101100111",4
"34,14,11,4,29,8,29,26,25,29","25,15,13,4,21,13,22,20,23,21",10,100,125,129,"1001101001","1010100101",4
"16,12,4,1,2,29,15,29,18,18","23,17,3,1,1,24,10,21,15,23",10,100,116,116,"0011111111","0011111111",0
"14,31,11,20,5,17,7,7,8,8","15,21,12,15,5,25,8,7,13,6",10,100,103,106,"1111101101","1111001111",3
"22,17,22,18,10,26,20,22,2,14","15,17,15,15,14,23,13,15,2,25",10,100,132,132,"1011011110","1011011110",0
"30,31,3,12,2,7,29,20,3,29","25,21,2,11,1,8,20,17,2,22",10,100,127,133,"1110101011","1101101001",6
"24,9,1,16,20,2,16,13,29,18","17,6,1,22,13,1,15,19,22,23",10,100,119,119,"1110111011","1110111011",0
"4,18,13,14,8,18,26,12,21,1","4,23,19,25,14,23,23,11,21,1",10,100,90,91,"1100101111","0010011111",1
"29,14,8,1,1,16,6,17,8,20","23,25,6,1,1,21,11,17,13,15",10,100,100,100,"1011110111","1011110111",0
"30,8,16,4,16,10,11,8,14,17","21,9,15,3,21,7,15,11,10,17",10,100,110,111,"1111011011","1110110011",1
"7,11,18,3,11,29,1,5,7,13","8,12,19,2,13,22,1,5,11,13",10,100,98,99,"1111111101","1111110011",1
"33,3,29,34,6,24,16,6,8,29","24,2,24,25,8,17,15,8,6,20",10,100,131,134,"1101010011","1001010111",3
"7,6,8,6,24,34,8,2,21,6","7,5,13,8,16,25,8,1,18,8",10,100,114,114,"1101111111","1101111111",0
"31,18,12,24,14,16,7,12,14,22","21,15,11,17,25,15,7,17,25,15",10,100,123,123,"1111010001","1101010101",0
"16,6,13,4,29,12,8,3,8,13","15,5,13,4,20,11,6,2,14,19",10,100,104,104,"1111111101","1111111101",0
"6,10,8,3,2,30,8,8,31,19","7,7,8,2,1,21,8,8,21,14",10,100,125,125,"1111111111","1111111111",0
"30,9,20,7,5,23,6,18,24,4","21,6,17,7,5,18,7,23,17,3",10,100,122,124,"1111110011","1111111010",2
"33,8,16,18,10,24,29,7,19,18","24,8,23,23,7,16,23,11,14,23",10,100,123,123,"1100111010","1000011011",0
"24,8,26,7,21,3,12,7,24,13","17,6,20,7,21,2,17,7,16,13",10,100,120,123,"1111110110","1110100111",3
"18,30,14,11,11,29,19,13,18,8","23,21,15,13,15,22,14,18,25,8",10,100,111,114,"0111011001","0111111000",3
"2,7,18,19,26,2,20,13,3,16","1,8,23,14,23,1,13,13,2,21",10,100,110,110,"1111111110","1111111110",0
"29,25,13,23,17,16,11,7,1,2","21,23,13,17,25,15,13,7,1,1",10,100,116,116,"1111010111","1111010111",0
"5,13,2,34,31,6,21,14,20,1","5,18,2,25,21,6,21,10,13,1",10,100,113,129,"1011110111","0011111111",16
"3,29,16,6,16,33,16,12,16,12","2,24,22,11,22,24,12,17,12,17",10,100,113,113,"1110011010","1100111010",0
"3,18,16,7,19,29,7,19,8,3","2,25,21,11,17,24,8,14,14,2",10,100,103,103,"1011111101","1011111101",0
"25,31,8,6,18,5,18,6,17,6","23,21,13,8,15,3,19,5,17,8",10,100,114,115,"1101110111","1100101110",1
"18,2,19,16,2,6,11,6,22,10","25,1,17,15,1,6,15,7,16,14",10,100,94,97,"0111111111","1011010111",3
"14,14,13,1,6,7,30,16,4,29","10,25,18,1,8,7,21,23,4,23",10,100,104,107,"1011111011","1001111111",3
"8,15,7,29,16,14,8,18,5,7","6,16,7,20,22,25,11,23,5,11",10,100,98,98,"1111100110","1111100110",0
"16,8,5,29,16,7,17,2,29,8","21,9,5,20,15,7,25,1,23,11",10,100,104,110,"0111110111","1111110010",6
"8,30,11,15,16,6,8,20,7,5","8,20,15,10,21,11,8,13,8,3",10,100,109,113,"1101101111","1111101101",4
"8,18,3,8,14,8,18,25,10,4","14,23,2,6,10,9,15,23,14,3",10,100,98,101,"0111111101","0101111110",3
"16,19,25,16,20,18,4,7,4,16","15,17,23,19,13,23,4,7,3,15",10,100,111,111,"1110101111","1110101111",0
"26,3,30,33,18,21,24,6,6,18","20,2,21,24,25,21,17,11,11,25",10,100,122,122,"1111001100","1111001010",0
"13,29,7,19,18,7,25,14,13,19","19,20,7,17,25,7,23,10,13,17",10,100,113,119,"0111001101","0101001111",6
"19,13,7,29,9,13,18,21,31,29","17,13,11,20,6,19,15,21,21,20",10,100,135,135,"1001101011","1001101011",0
"14,1,20,6,15,6,19,7,30,16","15,1,13,7,16,11,17,7,20,23",10,100,112,112,"1111101110","1110111110",0
"15,12,11,29,6,8,33,8,1,30","10,17,12,22,11,6,24,13,1,25",10,100,127,127,"1011011011","1011011011",0
"20,7,26,18,31,18,16,8,16,7","13,7,23,12,21,23,19,8,15,8",10,100,126,126,"1111100110","1011100111",0
"29,11,22,29,30,16,23,30,5,16","20,15,15,24,25,19,17,20,5,19",10,100,133,134,"1011001100","1010101100",1
"14,2,25,20,6,4,11,5,6,17","15,1,23,13,5,3,15,5,6,25",10,100,93,99,"1111111110","1111110111",6
"14,16,34,8,23,16,4,14,15,4","10,21,25,13,18,15,3,25,10,4",10,100,118,118,"1011111011","1011111011",0
"5,23,22,7,4,19,1,19,7,8","5,17,15,7,3,14,1,17,7,14",10,100,115,115,"1111111111","1111111111",0
"4,17,16,33,2,15,14,13,15,8","4,25,22,24,2,10,25,18,16,9",10,100,93,100,"1011110011","0011010111",7
"20,1,3,7,15,2,26,16,8,29","17,1,2,8,10,1,23,21,13,21",10,100,111,113,"1111111011","1001101101",2
"18,1,16,20,22,18,12,31,16,13","23,1,22,17,15,25,17,21,12,19",10,100,108,108,"1101100110","0101110110",0
"1,29,18,20,16,6,24,2,19,1","1,23,19,13,12,8,17,1,14,1",10,100,118,129,"1101111111","0111101111",11
"14,5,6,29,8,34,13,1,16,2","10,3,8,22,6,25,13,1,19,2",10,100,112,121,"1111111101","1101111011",9
"2,33,5,6,2,26,1,24,8,6","1,24,5,6,1,20,1,17,9,11",10,100,113,113,"1111111111","1111111111",0
"8,8,3,30,8,20,7,3,8,24","13,8,2,21,14,15,7,2,6,17",10,100,111,112,"1111011111","1111110111",1
"10,8,29,6,15,13,8,16,16,7","7,14,24,8,10,13,14,12,23,8",10,100,104,106,"1111110101","1010110111",2
"23,29,30,24,8,6,16,26,2,26","18,24,20,17,14,7,15,23,1,23",10,100,124,127,"1111001010","0111001011",3
"4,29,22,22,10,7,31,5,8,4","3,23,16,15,14,7,21,5,14,4",10,100,124,125,"1111011101","0111111001",1
"18,16,13,17,25,12,13,30,29,15","19,15,19,25,23,17,18,25,21,16",10,100,115,115,"0100100111","0100100111",0
"18,1,14,2,16,7,29,6,1,11","25,1,15,1,21,7,20,8,1,15",10,100,87,94,"0111111111","1111111110",7
"7,8,16,18,19,20,2,20,18,3","7,6,15,25,17,17,2,15,25,2",10,100,95,106,"1110111101","0110111111",11
"18,14,2,8,5,6,18,26,19,6","19,15,1,8,3,5,23,23,14,7",10,100,104,104,"1111110111","0111111111",0
"25,18,4,26,18,9,14,30,19,6","23,15,3,20,25,6,25,21,17,8",10,100,112,122,"0111010111","1111000110",10
"7,29,10,16,10,16,29,18,15,23","7,24,7,22,7,21,20,19,10,17",10,100,123,124,"1110101011","0100101111",1
"13,14,31,11,4,34,23,20,11,23","13,10,21,12,4,25,17,15,15,17",10,100,129,135,"0110111001","0010111101",6
"26,21,15,2,18,33,16,2,8,15","23,18,16,1,15,24,15,1,6,16",10,100,110,118,"1101110110","1000111111",8
"14,26,4,13,31,14,23,3,16,6","10,23,3,19,21,15,18,2,12,5",10,100,123,124,"1110101111","1100111010",1
"21,29,10,16,5,25,14,9,18,2","21,24,14,15,3,23,15,6,19,1",10,100,107,109,"1101110101","1100110111",2
"16,16,8,18,16,10,22,2,19,31","23,15,8,19,22,7,15,2,14,21",10,100,108,124,"0110011111","0111011011",16
"30,11,2,7,6,11,14,22,8,18","21,12,1,11,5,15,10,16,8,19",10,100,111,114,"1110101111","1110111101",3
"16,18,30,4,29,2,30,16,24,15","19,12,21,3,22,1,21,15,16,16",10,100,137,137,"0111111010","0111111010",0
"13,21,6,10,24,29,33,2,31,26","19,21,6,14,17,21,24,1,21,23",10,100,125,129,"0010111110","0001111110",4
"7,20,9,15,29,7,18,5,26,11","7,15,6,16,23,7,15,3,23,12",10,100,121,121,"1110111110","1110111110",0
"2,2,14,4,8,16,5,13,18,7","1,1,10,4,13,23,5,13,12,7",10,100,89,89,"1111111111","1111111111",0
"8,18,16,23,22,16,14,6,4,15","13,23,15,17,16,22,15,11,3,16",10,100,102,103,"1011101011","0111101110",1
"24,2,26,2,13,31,6,1,10,18","16,1,23,1,18,21,11,1,14,23",10,100,114,114,"1111010111","1111010111",0
"5,8,26,8,6,26,26,7,1,14","5,13,20,11,7,20,23,7,1,10",10,100,111,114,"1010111111","0011111111",3
"6,7,18,6,8,16,2,11,8,30","8,7,23,8,6,19,1,12,13,21",10,100,98,98,"1110111101","0111111101",0
"33,6,30,1,7,30,18,6,13,20","24,11,25,1,11,20,12,11,13,13",10,100,132,132,"1011011001","1011011001",0
"15,5,34,16,11,10,16,15,17,26","16,5,25,22,15,14,15,10,17,23",10,100,113,113,"0110001111","0110001111",0
"6,20,6,34,15,16,2,22,3,21","5,15,11,25,10,12,1,16,2,18",10,100,124,133,"1111111110","0101111111",9
"12,21,22,15,18,2,29,24,23,8","17,21,16,16,25,1,20,16,17,11",10,100,121,123,"0110011110","0011011111",2
"10,21,20,1,13,8,18,8,17,13","14,18,13,1,13,9,19,6,25,19",10,100,99,102,"1111111100","0111111101",3
"29,26,26,8,25,16,10,21,2,23","23,20,20,13,23,19,14,18,2,17",10,100,127,127,"1110000111","1110000111",0
"2,21,21,4,12,18,18,3,22,4","1,18,21,3,11,23,19,2,15,3",10,100,107,107,"1111101111","1111101111",0
"4,4,9,16,8,23,14,18,20,29","4,3,6,19,6,18,10,19,15,20",10,100,111,125,"1110111011","0110111111",14
"14,2,29,4,11,20,16,16,7,2","25,1,20,4,12,13,15,23,11,1",10,100,107,107,"0111111111","0111111111",0
"8,1,14,2,24,2,22,1,20,18","9,1,25,1,16,1,16,1,15,23",10,100,98,104,"1101111111","0111111111",6
"13,16,17,13,4,19,23,14,18,8","13,22,25,13,4,17,18,10,25,11",10,100,102,104,"1101111100","1001111110",2
"4,14,18,3,4,15,13,5,14,6","4,25,23,2,3,10,19,5,10,8",10,100,82,87,"1011111111","0111111011",5
"29,18,8,18,7,23,2,5,14,6","22,23,6,25,7,18,1,5,25,11",10,100,98,103,"1110111101","1111011100",5
"12,31,11,2,8,4,8,2,34,22","11,21,13,1,13,4,6,1,25,16",10,100,126,126,"1111011111","1111011111",0
"15,29,30,30,7,6,6,23,14,17","16,23,21,25,7,8,6,17,10,25",10,100,126,126,"0111000110","0111000110",0
"26,16,30,8,9,19,17,10,18,4","23,21,20,13,6,14,25,14,25,3",10,100,112,112,"1111110001","1111110001",0
"3,16,22,16,1,29,12,6,11,8","2,12,16,15,1,20,17,8,13,13",10,100,112,112,"1111110111","1111110111",0
"12,11,1,14,24,24,19,30,30,33","17,15,1,25,16,17,17,25,21,24",10,100,131,131,"0010111011","0010111011",0
"8,20,16,8,2,3,7,11,20,26","9,17,23,13,1,2,7,12,13,23",10,100,105,106,"1101111111","1110110111",1
"14,18,7,29,14,6,23,2,6,10","15,15,11,22,15,8,18,1,5,7",10,100,116,116,"1101101111","1101101111",0
"8,15,16,16,29,30,1,13,8,29","8,16,23,19,21,25,1,18,9,20",10,100,120,120,"1100111011","1100111011",0
"2,12,16,8,17,18,3,8,6,2","1,17,15,6,25,23,2,13,8,1",10,100,84,84,"1111111011","1111111011",0
"17,14,18,4,20,2,6,11,24,21","25,15,25,4,13,1,8,13,17,21",10,100,102,105,"0101111111","0110111011",3
"33,6,10,6,22,22,17,29,16,29","24,7,14,7,15,15,25,24,21,22",10,100,135,135,"1000110101","1000110101",0
"29,6,16,29,4,15,5,3,21,11","24,6,12,21,4,10,5,2,18,12",10,100,123,125,"1111110110","1111111010",2
"8,1,18,1,2,13,11,22,2,1","8,1,23,1,2,19,12,16,2,1",10,100,79,79,"1111111111","1111111111",0
"11,5,20,21,21,30,29,18,14,30","15,5,13,21,21,21,20,23,10,20",10,100,128,135,"0110011011","0110111001",7
"2,21,26,18,14,16,8,20,16,5","1,21,20,23,15,21,9,13,15,5",10,100,112,112,"1110101111","1110101111",0
"29,19,13,2,29,30,3,26,18,17","22,14,13,1,20,20,2,23,23,25",10,100,125,135,"1111111000","1101110100",10
"21,22,20,8,2,13,14,4,9,16","18,16,17,8,1,13,10,4,6,22",10,100,113,113,"1111111110","1111111110",0
"17,21,6,15,22,8,7,33,6,11","25,21,5,10,16,8,7,24,7,15",10,100,118,118,"0111111110","0111111110",0
"16,16,19,12,6,30,26,20,8,8","19,22,14,17,11,25,23,15,8,13",10,100,111,111,"0010011111","0010011111",0
"13,7,14,19,18,33,14,7,6,31","13,8,25,17,12,24,10,11,6,21",10,100,128,128,"1001111001","0101111011",0
"29,8,18,18,1,29,21,13,14,17","20,13,19,19,1,22,21,13,25,17",10,100,110,115,"1000111101","1001111001",5
"7,14,19,29,4,24,8,13,5,2","8,10,17,23,4,17,6,19,5,2",10,100,112,114,"1111111011","0111011111",2
"19,19,16,18,16,12,14,4,6,21","14,14,15,23,15,11,15,3,8,18",10,100,113,113,"1110110111","1110110111",0
"29,29,31,30,4,16,16,4,13,10","23,24,21,25,4,22,23,4,19,7",10,100,129,129,"1111000001","1111000001",0
"7,18,30,19,16,30,26,24,29,11","8,25,21,17,19,21,20,17,24,12",10,100,129,132,"0011011100","0011010110",3
"18,24,18,7,7,6,7,14,24,18","25,17,25,7,7,8,11,25,17,25",10,100,93,98,"1101111010","0111100011",5
"23,8,18,29,29,4,18,18,8,6","17,13,25,20,20,3,15,12,6,8",10,100,129,131,"1001111110","1001101111",2
"11,14,14,8,18,10,29,1,25,6","13,15,25,13,25,7,21,1,23,8",10,100,96,103,"1100011111","0100111111",7
"5,16,14,16,10,1,31,2,22,30","5,22,25,21,14,1,21,1,15,21",10,100,117,117,"1001111111","1001111111",0
"4,2,7,2,14,16,18,22,3,29","4,1,11,1,15,15,25,16,2,24",10,100,99,106,"1111110111","0101111111",7
"29,16,14,29,4,1,2,1,18,30","21,22,25,22,3,1,1,1,12,25",10,100,114,114,"1001111111","1001111111",0
"16,30,13,1,16,17,31,7,12,8","19,20,18,1,22,25,21,11,17,11",10,100,102,106,"1101101001","1101101010",4
"12,24,8,20,18,18,5,3,18,18","17,17,11,15,25,23,3,2,23,15",10,100,106,106,"0101011111","0101011111",0
"18,18,10,16,29,34,26,8,20,7","25,12,7,19,21,25,23,6,13,11",10,100,126,135,"0110110111","0100111110",9
"29,8,17,1,22,8,16,24,14,13","20,11,17,1,16,14,23,16,10,19",10,100,115,120,"1111100110","1011100111",5
"7,18,5,16,3,4,18,8,5,8","7,25,5,22,2,3,23,14,3,13",10,100,76,80,"1111111010","1111101011",4
"11,5,16,14,7,3,22,13,13,6","15,5,19,25,7,2,16,18,13,8",10,100,83,91,"1110111011","1010111111",8
"8,4,4,11,18,9,7,29,2,8","11,3,3,15,12,6,7,24,2,13",10,100,100,100,"1111111111","1111111111",0
"11,24,7,2,2,18,8,16,21,24","12,17,7,1,1,19,14,22,18,17",10,100,109,110,"1111110011","0110010111",1
"1,18,15,14,13,1,16,6,30,22","1,12,16,15,13,1,15,7,21,15",10,100,116,121,"1110111011","1101111111",5
"6,18,23,20,5,11,29,6,19,4","8,25,17,17,5,15,22,8,17,4",10,100,112,112,"1011101111","0011011111",0
"18,6,20,12,5,17,19,16,12,3","25,11,17,11,5,25,14,22,17,2",10,100,93,94,"1011101101","1011111001",1
"30,4,18,30,18,17,19,29,1,13","25,4,12,21,23,25,17,22,1,19",10,100,127,127,"1011001110","1011001110",0
"4,23,22,7,29,22,2,30,24,7","3,18,15,8,24,15,2,25,16,11",10,100,126,133,"1110111010","1010111110",7
"29,26,18,8,13,14,11,8,16,1","21,20,25,13,19,10,15,13,22,1",10,100,97,104,"1100011011","1110010011",7
"2,26,7,25,26,6,15,14,30,1","1,20,7,23,20,6,10,10,20,1",10,100,127,130,"1110111111","1101111010",3
"10,1,1,14,6,22,4,11,29,18","7,1,1,10,7,16,4,12,22,25",10,100,98,111,"1111111110","1011110111",13
"8,8,14,6,16,20,9,5,29,9","8,8,10,7,22,15,6,5,21,6",10,100,108,116,"1111011111","0111111111",8
"7,10,14,18,15,6,4,16,6,16","8,14,10,23,10,6,4,15,7,21",10,100,96,98,"1111111110","1011110111",2
"11,23,16,13,4,18,13,6,13,4","15,18,21,18,4,23,18,8,13,3",10,100,84,91,"0110110111","0110111011",7
"5,1,6,7,8,26,4,23,24,16","5,1,8,7,9,23,3,18,16,22",10,100,104,109,"1111111110","0101111111",5
"15,2,20,26,8,20,23,1,5,18","16,1,15,23,13,13,17,1,3,25",10,100,112,117,"1111011110","1011111010",5
"8,7,5,17,13,7,8,2,16,11","13,8,5,25,19,7,11,2,23,13",10,100,69,76,"0110111111","0111110011",7
"16,23,7,24,16,23,30,6,20,4","21,18,7,17,19,18,25,7,13,4",10,100,127,127,"0111011010","0111011010",0
"10,22,1,31,8,16,7,14,2,14","14,16,1,21,13,15,7,15,1,10",10,100,117,117,"1111011111","1111011111",0
"11,6,1,6,18,15,18,8,29,23","13,8,1,5,23,10,25,13,20,17",10,100,109,109,"1111110011","0001111011",0
"7,7,18,6,13,16,23,14,6,4","7,11,19,6,18,19,17,25,8,4",10,100,93,93,"1011111011","1011111011",0
"16,6,8,6,23,19,10,14,15,21","23,7,13,7,17,14,7,10,16,21",10,100,114,114,"0101111111","0101111111",0
"8,12,25,1,29,20,8,18,16,6","6,17,23,1,24,13,6,15,19,6",10,100,115,116,"1011111101","0010111110",1
"5,16,5,11,4,17,18,2,12,15","3,19,3,12,3,25,25,1,17,16",10,100,88,88,"1111101111","1111101111",0
"2,16,29,3,4,10,5,29,6,7","2,22,24,2,4,7,3,24,8,7",10,100,95,107,"1011111111","1111011111",12
"2,16,20,15,13,18,21,8,16,21","1,15,15,10,13,25,21,13,19,18",10,100,108,111,"1111101001","1111001011",3
"29,8,6,26,6,13,24,23,2,16","21,8,8,23,8,13,17,17,1,22",10,100,125,125,"1101011110","1101011110",0
"16,3,16,26,7,8,29,21,16,18","19,2,23,20,11,6,24,18,22,19",10,100,112,112,"0101111101","0101111101",0
"1,18,19,7,17,2,17,18,16,8","1,25,14,7,17,2,25,19,15,13",10,100,98,98,"1111110110","1111110110",0
"6,17,11,24,2,21,25,5,34,5","5,17,15,17,2,18,23,5,25,5",10,100,122,122,"1001111111","1001111111",0
"4,2,33,4,29,15,6,8,7,29","4,1,24,4,22,16,8,14,8,21",10,100,123,123,"1111110011","1111110011",0
"6,8,14,5,18,17,30,16,33,14","8,14,10,5,12,25,25,23,24,25",10,100,114,116,"1111101010","0011101110",2
"8,4,29,26,22,6,2,15,2,16","14,4,23,20,15,8,1,10,1,12",10,100,122,124,"0111111111","1111101111",2
"14,29,18,2,16,20,1,16,2,2","15,23,19,1,15,17,1,12,2,2",10,100,106,106,"0111111111","0111111111",0
"30,18,6,5,15,6,2,29,16,7","20,25,7,5,10,11,1,21,15,7",10,100,116,117,"1011111111","1100101111",1
"1,8,11,16,31,1,7,8,26,18","1,8,13,23,21,1,11,13,20,19",10,100,103,104,"1110111011","1110110111",1
"8,25,13,6,24,6,11,14,21,14","11,23,18,8,16,6,13,10,18,25",10,100,107,109,"0101111110","1100111110",2
"6,8,34,17,3,6,12,18,29,16","8,6,25,17,2,11,17,23,21,22",10,100,109,112,"0111100110","1111000110",3
"20,8,1,14,29,3,5,22,18,18","17,8,1,10,24,2,5,15,25,23",10,100,102,115,"1111111100","1111110101",13
"12,24,29,13,16,1,10,26,6,16","17,17,23,19,12,1,14,20,8,22",10,100,112,115,"0110111110","0111110110",3
"16,11,15,17,21,18,10,6,29,3","12,12,10,25,21,23,7,8,20,2",10,100,111,113,"1110101111","1110110011",2
"29,15,20,2,7,8,21,18,2,29","20,10,15,1,7,6,21,25,1,21",10,100,112,129,"1111110011","1110111001",17
"19,24,1,18,6,21,7,24,21,15","17,16,1,25,11,21,11,17,21,10",10,100,111,113,"1110011101","0110011111",2
"31,19,2,6,33,9,22,16,8,2","21,17,1,8,24,6,16,23,8,1",10,100,126,128,"1110111011","1101111010",2
"8,2,20,7,20,10,3,29,14,17","11,1,15,7,13,14,2,21,25,17",10,100,106,114,"1111101101","1011111101",8
"21,18,12,12,14,15,18,13,12,15","18,23,11,17,10,10,25,13,17,16",10,100,102,102,"1011110101","1010110111",0
"20,18,2,24,24,24,29,7,11,26","13,19,1,17,16,17,22,7,15,23",10,100,130,132,"1011111100","1010111101",2
"6,6,1,11,8,34,14,30,12,2","8,11,1,12,9,25,10,20,11,1",10,100,118,118,"1011111111","0111111111",0
"24,18,30,7,1,30,2,16,2,20","17,25,25,7,1,25,1,21,1,15",10,100,116,116,"1011111011","1011111011",0
"6,5,21,3,3,6,23,34,25,33","7,5,18,2,2,7,18,25,23,24",10,100,122,126,"0111101101","0101101111",4
"16,30,7,8,18,6,7,1,8,8","15,20,11,11,19,8,7,1,9,13",10,100,94,100,"1101111110","1111111010",6
"31,10,4,29,13,4,16,19,16,12","21,7,4,23,18,3,15,14,15,17",10,100,125,125,"1101011110","1101011110",0
"7,30,20,8,13,16,22,14,20,2","8,20,13,13,19,12,15,15,13,1",10,100,131,131,"1110011111","1110011111",0
"14,7,8,29,14,7,16,25,14,6","10,7,14,24,25,8,23,23,10,5",10,100,102,105,"1101010111","1001011110",3
"13,6,20,6,5,8,24,20,8,12","18,7,13,6,5,11,16,13,9,11",10,100,109,114,"0111111111","1111101111",5
"7,8,24,18,23,30,2,8,24,14","11,6,16,25,17,21,1,8,17,15",10,100,126,131,"1110111110","0110110111",5
"8,10,22,33,16,12,7,15,6,19","13,7,16,24,19,11,8,10,7,14",10,100,124,124,"0111011111","0111011111",0
"5,2,2,9,4,18,16,20,12,23","3,1,1,6,4,12,22,17,11,18",10,100,111,111,"1111111111","1111111111",0
"14,2,4,20,23,30,6,7,5,1","15,1,4,17,18,25,7,7,5,1",10,100,112,112,"1111111111","1111111111",0
"7,22,14,6,30,22,18,6,6,15","7,15,10,8,21,15,23,8,8,16",10,100,122,122,"1111110101","1110110111",0
"29,26,29,8,22,12,8,19,30,21","21,20,20,11,16,17,13,14,20,21",10,100,129,136,"1010100110","1110100010",7
"5,16,8,7,30,23,6,20,18,8","5,21,8,7,20,18,5,13,19,8",10,100,107,120,"1011111101","0011111111",13
"24,19,20,12,16,18,21,23,16,1","17,17,13,11,15,25,18,17,12,1",10,100,124,124,"1110001111","1110001111",0
"6,7,8,2,6,2,15,2,20,8","8,7,6,1,8,1,16,1,15,6",10,100,76,76,"1111111111","1111111111",0
"6,6,8,11,8,29,11,14,8,15","7,8,13,12,14,24,12,25,11,16",10,100,86,88,"1101011011","0001011111",2
"8,7,10,5,5,14,11,16,5,13","13,7,14,5,5,25,13,15,3,19",10,100,80,81,"1111101111","1111111110",1
"8,1,18,8,29,11,6,4,18,6","9,1,25,13,22,13,7,3,15,11",10,100,95,96,"1110111110","1011110110",1
"6,5,16,20,26,18,7,29,18,16","5,3,22,13,23,15,7,24,19,23",10,100,111,117,"1101111100","1001110110",6
"8,6,18,26,4,5,23,6,30,25","9,8,19,23,3,5,18,8,21,23",10,100,113,117,"0001111011","1001011011",4
"34,7,29,18,29,2,14,13,12,7","25,11,23,23,20,1,15,13,17,7",10,100,121,121,"1110110101","1110110101",0
"2,2,7,4,33,3,12,3,18,29","1,1,7,4,24,2,17,2,19,23",10,100,113,113,"1111111111","1111111111",0
"29,11,13,26,29,18,30,13,18,26","23,12,18,20,23,23,20,18,19,20",10,100,122,125,"1101001001","1100101001",3
"11,4,1,15,1,11,31,33,20,16","13,3,1,16,1,15,21,24,15,19",10,100,116,121,"1111101110","0111101111",5
"18,20,29,19,14,30,33,12,17,8","15,17,22,14,15,25,24,17,17,6",10,100,127,129,"1111001001","1011011000",2
"14,17,18,7,23,15,7,24,2,14","10,25,25,11,18,16,11,17,1,10",10,100,110,110,"1010110111","1010110111",0
"22,7,13,2,5,7,6,16,6,16","15,7,19,1,3,7,8,19,11,15",10,100,94,94,"1111111101","1111110111",0
"6,11,6,4,14,30,2,26,19,1","8,15,8,4,25,20,1,23,14,1",10,100,105,105,"1111011111","1111011111",0
"6,25,6,2,16,1,10,23,14,18","8,23,6,1,12,1,7,18,10,25",10,100,103,109,"1111111110","0101111111",6
"9,16,20,14,16,10,1,4,17,15","6,12,15,15,12,7,1,4,17,16",10,100,108,117,"1110111111","1111110011",9
"17,2,18,16,2,18,21,6,8,24","17,1,23,15,1,23,18,5,6,17",10,100,96,108,"1101101111","1101111011",12
"13,1,8,22,1,1,2,11,5,19","18,1,11,15,1,1,2,15,5,14",10,100,83,83,"1111111111","1111111111",0
"16,18,30,2,5,5,24,16,19,4","21,25,25,1,3,5,16,15,14,3",10,100,105,117,"0011111111","1011111110",12
"2,16,6,11,23,16,26,20,16,14","1,12,5,13,17,15,23,15,22,10",10,100,123,123,"1110111101","1110111101",0
"20,8,9,8,33,25,18,5,4,25","15,11,6,11,24,23,25,3,3,23",10,100,121,121,"1010110111","1010110111",0
"5,8,5,4,17,3,4,7,1,26","5,11,3,4,17,2,4,7,1,20",10,100,80,80,"1111111111","1111111111",0
"6,5,1,21,18,29,7,23,30,7","11,5,1,21,23,21,7,18,25,7",10,100,116,118,"0111011110","0011011111",2
"23,2,17,15,3,4,34,13,13,12","18,1,25,16,2,3,25,13,18,17",10,100,107,107,"1101111110","1101111110",0
"18,2,13,6,30,8,2,14,14,6","23,1,13,8,21,6,1,10,15,5",10,100,107,107,"1110111111","1110111111",0
"8,13,10,19,6,17,8,16,4,3","6,18,14,14,8,25,11,15,4,2",10,100,87,91,"1111101111","1011111111",4
"8,9,8,9,1,16,16,5,29,22","13,6,13,6,1,22,23,3,20,15",10,100,107,107,"0101111111","0101111111",0
"7,11,29,6,16,15,30,8,5,1","7,13,21,11,15,16,25,8,5,1",10,100,111,111,"1010111111","1010111111",0
"30,26,14,16,6,8,7,19,12,7","20,20,10,15,11,13,7,17,17,7",10,100,119,119,"1111001101","1111001101",0
"18,7,15,5,14,18,26,16,16,6","23,7,16,5,15,12,23,15,19,11",10,100,101,105,"0111111100","0010111110",4
"7,24,10,30,8,8,18,18,5,18","7,17,14,21,13,13,19,19,3,15",10,100,112,115,"1111001011","1101001101",3
"22,26,5,30,29,16,11,8,29,30","16,23,5,21,24,21,13,14,22,25",10,100,115,123,"1011100010","0011100011",8
"11,16,2,22,23,4,6,7,34,24","13,22,1,16,18,3,5,7,25,17",10,100,122,127,"0011111111","1011110111",5
"8,24,18,30,29,8,34,18,25,34","9,16,15,21,24,14,25,15,23,25",10,100,130,131,"1101001001","0101000111",1
"11,18,25,23,8,2,14,29,18,2","12,23,23,17,14,1,25,20,15,1",10,100,110,117,"1011010111","0111010111",7
"18,8,26,21,2,1,10,30,6,33","12,6,23,18,2,1,7,21,8,24",10,100,129,130,"1101111111","1011100101",1
"31,29,6,19,16,16,6,13,16,17","21,23,6,17,21,19,8,13,23,25",10,100,114,114,"1111010100","1111010100",0
"26,29,15,7,18,21,22,16,25,12","20,21,10,7,23,21,15,15,23,11",10,100,129,129,"1110001011","1110001011",0
"15,8,22,22,15,6,7,20,14,30","16,6,15,15,16,8,11,17,25,20",10,100,123,124,"1111010101","0111101101",1
"12,23,20,12,16,10,3,14,14,15","11,18,15,17,15,14,2,10,10,16",10,100,117,117,"1110101111","1110101111",0
"15,22,14,4,16,25,22,24,15,14","16,15,25,3,15,23,16,16,10,15",10,100,128,128,"0101111110","0101111110",0
"18,2,29,26,16,22,14,33,21,6","23,1,24,20,12,15,10,24,18,11",10,100,134,134,"0101111110","0101111110",0
"13,2,8,24,17,1,21,22,10,19","13,2,13,17,25,1,18,16,14,14",10,100,112,112,"1101011111","1101011111",0
"8,15,10,4,8,19,13,8,11,2","9,16,7,4,6,17,18,6,12,1",10,100,98,98,"1111111111","1111111111",0
"8,18,11,20,2,5,1,26,22,20","13,12,13,17,1,5,1,20,16,17",10,100,114,122,"0101111111","0111010111",8
"26,22,11,24,6,29,11,7,6,19","20,16,15,17,5,20,15,7,11,14",10,100,133,133,"1101110101","1101110101",0
"31,22,6,13,6,29,16,22,26,4","21,15,6,19,6,23,12,15,23,3",10,100,130,134,"1110011101","1100010111",4
"15,6,3,18,6,8,16,6,10,7","16,11,2,23,11,11,23,6,7,8",10,100,83,83,"1011011111","1011011111",0
"8,17,24,8,7,18,34,16,5,16","11,25,16,6,7,19,25,22,5,19",10,100,112,112,"0011111011","0011111011",0
"8,16,9,29,24,5,29,12,7,6","11,22,6,24,17,5,22,17,8,8",10,100,109,115,"0011111011","0011111110",6
"18,13,13,18,20,5,8,4,1,30","12,18,13,15,13,3,11,4,1,21",10,100,117,122,"1011111111","1111110111",5
"7,13,7,11,16,22,8,4,7,7","7,19,7,12,15,16,14,3,8,8",10,100,94,94,"1111110111","1111110111",0
"6,22,17,6,24,20,31,8,1,19","8,16,17,11,17,15,21,8,1,14",10,100,133,133,"0110111001","0110111001",0
"10,15,17,18,19,20,16,12,22,8","14,10,17,25,17,13,22,17,15,13",10,100,109,111,"0110111010","1110110011",2
"16,3,1,26,2,18,21,2,7,14","23,2,1,23,1,25,21,2,7,10",10,100,94,94,"0111111111","0111111111",0
"12,30,12,7,21,22,6,29,5,33","11,20,11,7,21,16,8,21,5,24",10,100,133,133,"1101010101","0111010101",0
"21,13,1,22,4,13,18,11,3,8","21,19,1,15,4,19,25,15,2,13",10,100,88,90,"1011101111","1011111011",2
"14,22,7,19,29,17,29,7,2,20","15,15,8,14,21,25,24,7,1,15",10,100,128,128,"0101101111","0101101111",0
"14,14,26,8,18,19,5,6,24,3","10,25,20,6,23,17,5,11,16,2",10,100,117,117,"1011111011","1011111011",0
"3,25,19,16,8,17,12,10,12,8","2,23,14,22,9,17,17,14,11,6",10,100,102,104,"1110110111","1110111011",2
"30,20,12,14,20,21,13,6,6,2","21,17,17,10,13,18,18,7,6,1",10,100,119,120,"1101110111","1101111001",1
"29,2,2,20,26,21,13,18,4,4","22,1,1,17,20,18,18,19,3,4",10,100,108,120,"1111110011","1011110110",12
"13,16,31,17,18,18,8,1,18,11","18,12,21,25,23,23,6,1,25,15",10,100,92,102,"0110111100","0110111001",10
"18,10,8,24,16,6,20,6,1,8","23,14,11,17,19,8,15,11,1,13",10,100,93,97,"1011111010","1111101010",4
"4,34,2,9,6,14,29,26,6,30","4,25,1,6,11,10,24,23,7,25",10,100,122,124,"1111011001","0111011011",2
"8,17,18,13,5,18,16,8,16,13","13,17,15,13,5,19,22,14,22,19",10,100,87,90,"0111111000","0111010110",3
"7,29,7,8,6,29,1,2,26,7","11,24,11,6,5,21,1,1,20,7",10,100,115,115,"1101111111","0111111111",0
"14,29,29,22,8,6,8,6,26,3","10,21,24,15,13,8,13,8,20,2",10,100,129,129,"1111010011","1111000111",0
"8,3,6,33,8,11,8,18,2,11","13,2,8,24,8,15,14,23,2,12",10,100,92,94,"0111110111","0101111111",2
"1,15,13,24,8,34,18,6,24,30","1,16,18,17,6,25,25,8,17,25",10,100,127,127,"1001110111","1001110111",0
"2,30,9,18,11,33,12,25,6,16","2,21,6,25,13,24,11,23,7,19",10,100,117,122,"1110011110","1110111100",5
"7,29,16,8,18,12,11,20,29,12","7,22,12,6,15,11,13,17,24,11",10,100,120,121,"0111100110","1111000111",1
"22,11,24,16,22,8,20,4,2,8","15,13,16,22,15,8,15,3,1,6",10,100,121,124,"1110111111","1011111101",3
"29,30,6,16,17,1,1,30,1,6","20,20,8,22,25,1,1,21,1,8",10,100,104,118,"1110011111","1111000111",14
"20,4,34,16,2,18,7,24,14,14","15,3,25,23,2,23,8,17,10,10",10,100,119,124,"1110101111","1010010111",5
"15,25,14,24,6,1,25,14,30,4","10,23,10,17,8,1,23,10,21,4",10,100,127,129,"1111010111","1011111110",2
"18,6,30,15,2,12,34,18,10,22","23,5,25,10,1,11,25,23,14,15",10,100,121,123,"0111111001","0011011011",2
"23,22,5,26,11,26,17,6,14,6","17,16,5,23,12,20,25,6,15,6",10,100,114,120,"1111010101","1101110101",6
"12,16,21,11,12,7,29,16,18,20","11,12,18,13,11,7,20,22,15,15",10,100,123,123,"1110011011","0110111011",0
"18,8,17,8,30,8,10,22,3,14","23,14,17,9,21,14,7,16,2,10",10,100,112,114,"0111101111","1010101111",2
"9,14,16,4,23,6,5,20,24,6","6,10,22,4,17,8,3,17,17,7",10,100,111,117,"1101111111","1110101111",6
"16,29,8,2,6,22,18,26,4,26","15,22,14,1,6,15,25,20,4,23",10,100,125,125,"1101010111","1101010111",0
"4,30,8,13,8,18,2,10,29,15","3,25,11,13,6,23,1,7,23,10",10,100,119,119,"1111101111","1111101111",0
"16,5,16,10,8,13,18,8,1,30","22,3,23,14,13,19,25,13,1,20",10,100,88,88,"1101101011","0111001111",0
"1,18,16,34,6,24,14,29,2,7","1,23,19,25,6,17,15,24,1,7",10,100,117,119,"1001111111","1011110111",2
"13,18,19,11,23,16,14,8,12,6","18,15,17,12,17,19,15,14,17,11",10,100,101,102,"0111111000","0110111010",1
"18,26,33,31,13,30,15,30,16,23","12,20,24,21,13,21,16,20,22,18",10,100,142,142,"1011010100","1011010100",0
"8,16,30,5,2,10,26,4,8,18","13,15,21,5,1,14,23,3,11,23",10,100,101,106,"0111101101","0110111101",5
"2,20,8,26,16,1,14,4,9,5","1,13,8,23,23,1,10,3,6,3",10,100,105,105,"1111111111","1111111111",0
"16,1,4,6,13,11,24,6,6,4","22,1,4,8,13,13,16,5,8,4",10,100,91,91,"1111111111","1111111111",0
"19,13,16,6,14,1,7,26,6,6","17,13,21,8,10,1,8,23,8,8",10,100,96,101,"1110111100","1110101101",5
"4,29,14,6,7,6,33,8,18,16","3,21,10,11,7,7,24,14,12,15",10,100,127,127,"1110111011","1110111011",0
"3,1,11,29,19,22,29,24,12,3","2,1,13,22,14,15,24,17,17,2",10,100,130,130,"1101111101","1101111101",0
"10,30,19,2,10,16,23,24,14,1","14,21,14,1,14,12,17,17,10,1",10,100,129,129,"0111011111","0111011111",0
"16,6,2,19,29,4,33,18,20,6","21,8,1,17,20,3,24,25,13,8",10,100,123,123,"1011111010","1011111010",0
"10,24,9,16,8,8,8,6,1,22","7,16,6,19,11,6,8,8,1,15",10,100,112,112,"1111111111","1111111111",0
"2,14,19,16,15,6,19,4,18,24","1,25,17,23,10,8,14,3,25,17",10,100,107,107,"1010111111","1010111111",0
"8,2,3,2,7,11,33,24,8,7","6,1,2,1,7,12,24,17,11,8",10,100,105,105,"1111111111","1111111111",0
"21,12,6,6,24,20,11,10,14,18","21,17,5,6,16,13,13,14,10,25",10,100,112,112,"1011111110","1011111110",0
"6,20,6,14,1,8,15,19,11,23","8,15,11,10,1,9,16,14,12,17",10,100,111,111,"0101111111","0101111111",0
"7,14,3,17,6,16,14,33,25,5","7,25,2,17,5,21,15,24,23,5",10,100,110,110,"1011101111","1011101111",0
"18,4,18,6,11,6,18,24,24,20","25,3,19,8,15,7,12,17,16,15",10,100,120,120,"0111011111","0111011111",0
"20,26,2,6,12,8,10,2,4,11","13,23,1,8,11,13,7,1,3,12",10,100,101,101,"1111111111","1111111111",0
"12,1,4,1,2,19,34,29,6,18","17,1,3,1,1,17,25,23,8,15",10,100,114,116,"0111111111","1101111101",2
"12,13,23,18,22,6,31,6,4,26","11,13,18,23,16,11,21,11,4,23",10,100,118,120,"1010101011","1010101101",2
"8,24,6,8,2,14,20,7,9,29","14,17,8,11,1,15,17,8,6,22",10,100,111,113,"0110111111","0101111111",2
"18,3,34,11,21,31,13,11,26,6","25,2,25,12,21,21,18,15,20,8",10,100,121,123,"0110110011","0011110010",2
"4,9,8,14,26,30,18,6,16,21","4,6,9,10,20,21,23,11,15,21",10,100,120,120,"1101110011","1101110011",0
"3,20,7,6,15,6,16,26,10,2","2,13,8,11,16,7,22,23,7,1",10,100,105,105,"1110111111","1110111111",0
"8,22,29,29,29,1,14,6,7,7","6,16,23,21,23,1,10,11,8,7",10,100,132,132,"1111111000","1111111000",0
"33,6,9,26,29,18,30,4,33,30","24,8,6,20,22,23,21,4,24,20",10,100,139,139,"1010001111","1010001111",0
"2,5,10,2,26,20,12,7,1,11","1,5,14,1,23,13,17,7,1,12",10,100,96,96,"1111111111","1111111111",0
"13,33,4,15,8,4,3,19,16,17","13,24,4,16,6,3,2,14,23,17",10,100,116,116,"1111111101","1111111101",0
"19,20,34,6,11,16,3,11,22,6","14,15,25,6,13,21,2,15,15,7",10,100,121,121,"1111101011","1111001111",0
"20,16,2,4,1,7,18,20,16,22","13,12,1,3,1,7,23,13,12,15",10,100,126,126,"1111111111","1111111111",0
"14,16,6,21,30,18,13,16,21,18","10,12,8,18,21,19,18,12,18,12",10,100,121,126,"1111100101","1011100111",5
"14,21,6,14,29,16,22,6,16,7","10,21,8,10,24,15,16,6,19,8",10,100,116,117,"1101111000","1001111110",1
"19,2,30,10,8,4,29,6,1,4","17,1,25,7,9,4,20,7,1,3",10,100,113,113,"1111111111","1111111111",0
"18,24,6,18,3,24,3,18,8,5","12,17,6,12,2,17,2,23,13,5",10,100,119,119,"1111111101","1111111101",0
"16,25,5,19,16,5,17,2,14,12","19,23,5,17,22,3,17,2,15,17",10,100,99,101,"0111011111","1111011010",2
"21,7,29,2,2,29,2,26,3,14","18,7,21,1,1,22,1,20,2,10",10,100,128,130,"1011111111","1110111101",2
"33,8,26,10,11,34,8,26,6,17","24,11,23,7,15,25,13,20,8,17",10,100,129,129,"1011010100","1011010100",0
"5,11,23,2,2,29,14,7,6,22","5,12,18,1,2,20,10,7,5,15",10,100,121,121,"1111111111","1111111111",0
"14,10,7,14,2,30,1,7,6,18","15,14,8,25,1,20,1,11,8,12",10,100,95,98,"1110111111","1011110111",3
"4,14,5,1,8,15,19,16,22,19","4,15,5,1,14,10,17,22,15,17",10,100,107,109,"1111111011","1100011111",2
"8,21,3,16,25,29,8,18,6,23","6,18,2,23,23,20,13,23,6,17",10,100,115,117,"1110110011","1110111001",2
"2,5,25,15,24,18,34,19,6,3","1,5,23,16,17,25,25,17,11,2",10,100,112,120,"1110101101","0011101101",8
"20,16,16,12,24,16,12,7,29,10","15,21,15,17,16,12,17,7,23,14",10,100,112,117,"1010110110","1010111010",5
"20,6,18,16,2,11,7,16,4,17","15,5,25,12,2,12,7,15,4,17",10,100,99,104,"1101111111","1111001111",5
"14,25,10,13,13,30,20,13,7,2","10,23,7,19,18,25,17,18,11,2",10,100,108,112,"1110011011","1110011100",4
"2,20,20,6,18,14,6,8,19,14","2,13,15,8,23,15,8,11,14,15",10,100,107,107,"1110110011","0111011111",0
"6,24,17,9,25,6,18,12,14,30","5,17,17,6,23,11,23,17,15,21",10,100,117,119,"1111110001","0111100011",2
"4,30,16,10,17,1,7,14,3,2","4,25,23,7,25,1,11,10,2,1",10,100,97,97,"1111110111","1111110111",0
"15,14,1,30,2,4,18,23,13,29","10,10,1,20,1,4,23,17,19,23",10,100,118,126,"1111110101","1101100111",8
"13,16,29,15,26,10,18,16,1,19","13,21,21,16,23,14,23,21,1,17",10,100,103,107,"1011100011","0011101001",4
"22,6,23,7,13,26,20,10,16,7","16,11,18,7,13,20,17,14,12,7",10,100,121,121,"1011011011","1011011011",0
"11,24,29,29,3,16,16,8,14,33","15,17,20,22,2,15,21,9,10,24",10,100,132,134,"0111100011","0111110001",2
"30,29,7,18,15,19,33,21,26,2","21,23,7,15,16,14,24,21,23,1",10,100,131,131,"1101011001","1101011001",0
"18,23,6,3,13,2,1,21,7,3","15,18,8,2,13,1,1,18,8,2",10,100,97,97,"1111111111","1111111111",0
"10,1,9,16,16,6,8,14,14,24","7,1,6,22,23,8,6,15,10,17",10,100,102,104,"1111011111","1111111011",2
"22,22,26,14,4,8,6,8,16,2","16,15,23,10,3,13,7,14,21,1",10,100,112,112,"1111101011","1111101011",0
"8,12,7,6,11,14,20,18,15,21","11,17,7,7,15,10,17,12,10,21",10,100,112,112,"0011111111","0011111111",0
"2,17,10,34,26,22,1,16,8,30","1,17,14,25,20,16,1,15,6,21",10,100,123,131,"1001111011","1001111101",8
"21,12,12,24,22,2,30,29,16,18","18,11,17,17,16,1,20,22,22,12",10,100,137,137,"0101111101","0101111101",0
"6,24,7,6,15,10,8,12,12,5","6,17,8,7,16,7,9,11,17,5",10,100,93,100,"1111111101","1111111110",7
"16,31,6,16,34,6,6,26,9,29","22,21,8,12,25,7,8,20,6,20",10,100,131,136,"0111110011","0101100101",5
"16,21,13,8,14,13,15,23,29,16","22,18,13,8,15,19,10,18,20,15",10,100,117,118,"0110001111","0011101111",1
"29,29,6,22,2,14,29,24,13,14","24,24,8,16,1,15,20,17,13,10",10,100,126,131,"1011101101","0101001111",5
"5,1,16,5,9,11,20,24,24,21","5,1,22,3,6,15,17,17,17,18",10,100,120,120,"1101111111","1101111111",0
"6,7,34,18,18,14,6,3,8,29","7,7,25,23,25,25,8,2,8,21",10,100,105,108,"1111000111","1111001011",3
"6,12,6,8,6,30,15,6,3,14","8,11,8,6,11,25,10,7,2,10",10,100,106,106,"1111111111","1111111111",0
"29,10,7,3,20,6,29,3,34,15","24,7,7,2,17,6,20,2,25,10",10,100,130,133,"1111001111","1001101111",3
"30,19,2,13,6,16,18,26,16,24","21,14,1,18,8,15,12,23,23,16",10,100,125,125,"1110101101","1110101101",0
"24,19,16,18,18,14,16,21,8,8","17,17,12,15,23,10,22,18,13,11",10,100,120,120,"1111010101","1111010101",0
"4,18,8,16,15,12,17,16,16,5","4,12,6,12,16,17,17,15,12,5",10,100,115,115,"1111101111","1111101111",0
"22,24,12,20,2,16,6,9,17,13","15,17,11,15,1,15,8,6,17,18",10,100,122,122,"1111110110","1111110110",0
"11,21,18,2,3,12,7,8,16,21","13,21,19,1,2,17,7,14,22,21",10,100,91,93,"1111101101","1110111001",2
"20,4,11,16,14,16,18,13,4,30","15,3,12,22,15,23,23,19,3,21",10,100,101,103,"1110101011","1100101111",2
"8,5,34,14,20,16,16,16,14,17","13,5,25,10,13,22,12,21,25,25",10,100,113,113,"1111101100","1111101100",0
"8,16,5,18,30,7,8,19,14,16","14,22,5,23,20,7,11,17,25,15",10,100,103,103,"0011111101","0011111101",0
"25,9,15,34,26,16,29,8,5,8","23,6,16,25,20,21,22,13,5,13",10,100,123,123,"1101101000","1101101000",0
"7,6,1,14,19,3,6,21,17,22","11,7,1,10,14,2,8,21,17,16",10,100,109,110,"0111111111","1011111111",1
"18,13,7,11,21,12,12,6,8,21","12,19,7,12,18,17,11,8,6,21",10,100,104,105,"1011101111","1010111111",1
"2,25,18,18,16,6,16,29,23,22","1,23,23,23,23,8,22,21,17,16",10,100,107,117,"1100010111","1100001111",10
"18,21,4,2,14,11,6,13,25,16","25,21,3,1,10,13,6,13,23,21",10,100,96,101,"0111111110","0111101111",5
"16,11,2,24,1,20,18,29,6,29","19,15,1,16,1,17,23,20,7,24",10,100,111,121,"0011110111","0111010111",10
"6,3,29,29,7,29,22,7,6,1","7,2,23,21,11,21,16,7,11,1",10,100,126,126,"1111011101","1111011101",0
"29,2,7,12,15,3,8,21,26,8","22,1,8,17,16,2,14,18,20,11",10,100,111,111,"1110110111","1110110111",0
"8,5,5,3,3,8,4,6,7,29","8,5,5,2,2,13,4,8,7,22",10,100,78,78,"1111111111","1111111111",0
"2,20,2,20,31,2,30,5,15,19","1,15,1,13,21,1,20,3,10,17",10,100,127,142,"1111111110","0101111111",15
"18,19,29,18,11,5,11,4,16,5","25,17,23,23,12,5,15,4,22,5",10,100,91,98,"0111110101","0111111001",7
"4,18,16,1,17,11,23,30,2,19","3,25,21,1,25,13,18,21,2,17",10,100,106,108,"1011011111","1101011111",2
"14,8,7,7,17,11,24,16,10,14","10,11,11,7,25,12,16,22,7,15",10,100,104,104,"1101011111","1101011111",0
"1,26,5,3,8,5,16,24,29,8","1,23,3,2,13,5,22,17,22,6",10,100,109,116,"1111110111","0111011111",7
"4,6,2,19,19,2,23,20,20,16","4,6,1,17,17,1,18,13,17,19",10,100,115,115,"1111111110","1111111110",0
"1,8,14,23,4,3,19,8,5,8","1,11,10,17,3,2,17,13,3,13",10,100,93,93,"1111111111","1111111111",0
"6,16,13,5,19,7,10,21,24,1","7,22,18,5,14,7,14,21,17,1",10,100,99,102,"1101110111","0101111110",3
"24,14,31,3,7,10,10,18,30,6","16,25,21,2,11,14,14,25,21,8",10,100,112,116,"1011000111","1011001110",4
"17,4,33,3,26,11,2,22,33,34","25,3,24,2,20,13,1,16,24,25",10,100,131,135,"0111001111","0111101011",4
"6,18,9,23,8,16,34,5,6,18","6,19,6,18,6,12,25,5,8,23",10,100,119,120,"1111111100","1111111010",1
"6,7,21,29,4,7,23,14,18,12","8,8,21,22,3,7,17,25,19,17",10,100,109,109,"0111111010","0111111010",0
"8,16,18,4,14,7,1,15,18,6","11,15,23,4,10,8,1,10,19,7",10,100,99,100,"0111111111","1111101111",1
"23,3,14,26,4,7,24,1,24,6","18,2,25,20,4,7,17,1,17,8",10,100,118,118,"1101111111","1101111111",0
"22,14,8,14,18,16,21,20,16,4","16,25,11,15,23,23,18,13,15,4",10,100,105,111,"1011001111","1001101110",6
"6,18,3,11,30,14,19,6,4,15","6,25,2,15,25,10,14,8,4,16",10,100,108,108,"1011111111","1011111111",0
"14,8,2,14,17,16,5,18,6,6","25,13,2,15,17,19,5,19,8,11",10,100,86,86,"0111111110","0111111110",0
"16,16,15,6,30,30,31,24,15,20","15,23,10,5,25,21,21,17,16,17",10,100,136,136,"0011111100","0011111100",0
"29,34,9,3,5,5,6,24,29,8","21,25,6,2,5,5,8,16,23,11",10,100,133,133,"1111100110","1111010110",0
"14,16,25,4,8,11,19,30,13,4","15,22,23,4,8,13,17,20,13,3",10,100,103,113,"0011101111","1010101111",10
"6,6,24,29,33,30,8,8,10,17","8,8,16,24,24,25,11,13,7,25",10,100,126,126,"0011110010","0011110010",0
"14,20,4,5,8,34,33,29,26,8","15,13,3,3,13,25,24,22,23,11",10,100,125,131,"0111011100","0011011110",6
"5,29,22,6,16,13,16,4,26,21","5,20,16,8,22,19,12,4,20,21",10,100,123,123,"1110001111","1110001111",0
"20,24,29,18,2,19,14,16,23,19","17,17,22,15,2,14,10,22,18,14",10,100,130,132,"0110111011","0111010011",2
"16,1,18,23,8,14,1,16,2,20","15,1,12,17,9,15,1,15,1,15",10,100,111,118,"1111011111","1011111111",7
"18,26,18,15,20,20,15,4,3,2","23,23,12,10,15,13,16,4,2,1",10,100,123,123,"0111111111","0111111111",0
"12,9,24,16,29,2,16,23,20,6","17,6,17,22,21,1,22,17,17,8",10,100,113,121,"0110110111","0110101110",8
"2,33,23,19,17,12,1,26,2,17","1,24,18,14,25,17,1,23,2,17",10,100,123,123,"1111001111","1111001111",0
"4,34,8,29,22,6,16,20,30,23","3,25,9,24,15,11,12,13,25,17",10,100,127,133,"1110101101","1100100111",6
"1,6,30,31,5,21,7,23,14,14","1,7,20,21,5,21,7,17,25,25",10,100,124,124,"1111111100","1111111100",0
"11,5,6,18,16,12,1,16,6,30","12,5,6,15,22,17,1,15,11,25",10,100,99,102,"1111011101","1111100101",3
"30,8,19,26,12,13,20,1,16,16","20,6,14,23,11,18,13,1,23,23",10,100,116,121,"1111101100","1011111100",5
"3,11,18,34,2,23,16,20,18,26","2,12,25,25,1,18,15,17,15,23",10,100,116,124,"1001111110","1001010111",8
"8,29,10,10,14,21,16,20,16,16","8,22,7,14,10,21,21,15,22,12",10,100,118,118,"1110110101","1110110101",0
"2,8,4,10,1,3,13,1,24,31","1,8,4,7,1,2,13,1,17,21",10,100,97,97,"1111111111","1111111111",0
"8,22,6,5,4,9,20,24,16,7","6,15,8,5,3,6,15,17,12,7",10,100,121,121,"1111111111","1111111111",0
"16,11,11,33,4,13,8,7,7,5","22,13,12,24,4,13,11,11,7,5",10,100,100,100,"1111110011","1111110011",0
"5,21,7,2,33,12,11,29,3,19","3,18,8,1,24,11,13,22,2,14",10,100,124,126,"1101110111","0111110111",2
"8,21,13,3,6,7,8,4,7,9","13,18,13,2,11,7,11,4,7,6",10,100,86,86,"1111111111","1111111111",0
"16,6,5,26,16,12,1,29,34,13","19,5,5,20,22,11,1,24,25,19",10,100,113,118,"0111011110","1001011110",5
"7,31,17,21,24,29,8,29,34,2","11,21,25,21,16,20,9,24,25,2",10,100,128,131,"0100111011","0100011110",3
"30,14,2,11,8,12,17,6,16,22","25,10,1,12,13,17,17,7,19,15",10,100,110,112,"1111101101","1111001011",2
"13,18,30,3,1,8,14,18,1,1","13,25,20,2,1,11,10,12,1,1",10,100,107,107,"1111111111","1111111111",0
"6,7,11,7,13,8,29,29,2,6","6,8,12,11,18,13,20,20,1,8",10,100,103,105,"1110101111","0110111111",2
"4,11,21,18,18,15,7,24,29,7","4,15,21,23,25,10,8,17,21,7",10,100,107,114,"1010011111","0110011111",7
"16,16,22,24,29,24,6,6,2,6","21,22,15,17,23,17,8,8,1,8",10,100,117,119,"1011110010","0011111111",2
"31,18,29,30,8,12,8,8,7,12","21,25,21,25,13,17,13,8,7,11",10,100,117,118,"1011000111","1011001101",1
"7,14,7,4,6,21,6,14,16,1","7,15,7,4,6,18,11,10,21,1",10,100,96,96,"1111111111","1111111111",0
"25,18,20,7,12,33,13,8,16,30","23,15,17,7,17,24,18,9,22,25",10,100,116,116,"0111010101","0111010101",0
"21,13,7,6,16,6,26,4,23,17","18,19,7,5,15,8,23,3,18,25",10,100,109,109,"1011111110","1011111110",0
"14,18,3,7,9,16,6,26,23,24","10,23,2,7,6,19,8,20,17,17",10,100,122,122,"1011110111","1011110111",0
"6,6,14,29,7,11,10,16,19,2","11,7,25,21,8,13,7,15,14,1",10,100,106,106,"1101111111","1101111111",0
"15,16,29,7,34,29,2,18,8,10","10,19,24,8,25,23,1,12,9,14",10,100,127,127,"1010111100","1010111100",0
"18,16,29,34,24,29,29,18,14,30","23,12,24,25,17,23,21,19,25,21",10,100,133,133,"0101101001","0101101001",0
"6,2,24,14,8,30,16,23,2,4","8,1,16,10,11,21,21,18,2,4",10,100,115,119,"0111011111","1011011111",4
"29,6,13,6,11,29,13,22,6,7","23,5,13,6,15,23,19,16,7,7",10,100,118,118,"1111010111","1111010111",0
"1,3,14,12,3,5,6,16,7,11","1,2,10,17,2,5,5,21,8,12",10,100,78,78,"1111111111","1111111111",0
"31,23,4,6,29,16,12,20,20,1","21,18,4,7,20,22,11,15,13,1",10,100,136,136,"1100101111","1100101111",0
"22,19,16,4,15,17,18,24,24,5","16,14,21,3,16,17,25,17,17,5",10,100,115,125,"1101010111","1101110110",10
"4,7,4,7,7,15,20,4,30,18","4,8,3,7,7,16,17,4,20,25",10,100,98,105,"1111111110","0011111111",7
"12,20,25,19,12,18,11,6,2,3","17,13,23,17,17,25,13,5,1,2",10,100,104,104,"0111011111","0111011111",0
"24,18,14,24,6,21,13,17,8,8","17,15,10,16,11,18,19,17,11,13",10,100,118,118,"1111010100","1111010100",0
"16,8,30,29,11,18,8,11,30,12","15,13,25,22,12,23,13,13,21,11",10,100,117,117,"1011000011","1011000011",0
"21,29,17,33,8,26,16,23,14,22","18,21,17,24,6,23,12,17,25,15",10,100,131,133,"0101101101","0101010101",2
"16,16,20,5,17,4,30,11,8,2","12,23,13,5,17,4,20,15,11,1",10,100,113,113,"1011111111","1011111111",0
"7,5,20,18,20,4,21,8,29,1","7,3,15,12,15,3,18,8,24,1",10,100,125,126,"1111111011","0111111111",1
"29,18,4,1,5,29,11,21,31,18","24,25,4,1,3,21,15,18,21,12",10,100,134,134,"1001110111","1001110111",0
"8,4,1,17,29,6,7,13,15,14","11,4,1,25,21,8,8,19,10,10",10,100,97,101,"1110111111","1111111011",4
"21,20,16,18,4,19,29,23,31,7","21,17,12,12,4,14,20,18,21,7",10,100,136,137,"0011011110","0111001110",1
"8,9,20,2,7,29,33,29,10,21","11,6,15,1,8,20,24,23,14,21",10,100,129,130,"0111111100","1111011100",1
"6,8,29,1,34,23,29,15,34,18","8,13,23,1,25,17,24,10,25,25",10,100,135,135,"0010110110","0010110110",0
"8,25,3,1,29,2,26,29,30,2","6,23,2,1,24,2,20,23,20,1",10,100,130,130,"1011111111","1011111111",0
"4,15,24,18,15,26,8,25,16,1","3,16,16,23,10,20,13,23,21,1",10,100,110,114,"1110110101","0110111101",4
"18,5,6,2,19,2,29,30,18,5","25,5,7,2,14,2,22,21,15,5",10,100,116,116,"0111111111","0111111111",0
"4,19,21,29,12,18,8,29,3,30","3,17,18,23,11,19,8,24,2,25",10,100,116,120,"1011000111","0011001111",4
"18,5,10,1,26,18,14,5,21,22","25,3,7,1,20,25,25,5,18,16",10,100,108,108,"1111100111","0111110111",0
"12,18,18,14,18,18,8,1,10,8","11,15,19,10,19,19,11,1,7,9",10,100,99,108,"1111100111","1111110010",9
"30,29,7,13,13,5,8,12,22,1","20,20,7,18,13,5,11,17,16,1",10,100,115,120,"1110111011","1111110011",5
"1,1,20,7,2,10,16,16,18,5","1,1,13,7,1,14,15,15,25,5",10,100,96,96,"1111111111","1111111111",0
"18,7,15,18,30,11,16,6,13,2","23,7,16,12,20,15,23,7,13,2",10,100,109,109,"1111100111","1111100111",0
"6,24,16,7,29,11,19,8,4,8","6,17,15,7,21,15,17,14,4,11",10,100,113,113,"1111101011","1111101011",0
"21,2,7,2,14,30,20,19,29,6","21,1,7,2,25,25,13,17,22,6",10,100,121,121,"1100011110","1001011110",0
"19,11,30,34,8,16,5,24,7,7","14,15,21,25,6,23,3,16,7,7",10,100,134,134,"1011101111","1011101111",0
"5,20,24,2,16,14,10,6,14,20","5,13,16,1,15,10,7,11,10,17",10,100,125,126,"1111111011","0111111111",1
"21,29,5,23,1,33,10,3,16,18","21,21,5,18,1,24,14,2,22,23",10,100,115,119,"1111110100","1101011100",4
"7,8,14,6,11,18,30,3,29,29","7,6,10,8,12,25,25,2,22,24",10,100,120,121,"1110001111","0110101011",1
"29,8,15,5,2,30,25,6,22,14","24,11,10,5,1,20,23,8,16,10",10,100,123,128,"1011110111","1011111010",5
"1,26,30,14,7,18,16,33,16,17","1,20,20,10,11,25,15,24,15,17",10,100,120,126,"1111001100","0111100110",6
"18,4,15,10,3,26,18,20,3,3","25,4,16,7,2,23,25,17,2,2",10,100,102,102,"1111110111","0111111111",0
"17,20,1,24,15,11,4,13,1,6","17,15,1,17,10,13,3,18,1,6",10,100,99,111,"1111111011","1101111111",12
"18,20,18,14,8,14,11,2,16,8","15,17,12,15,13,25,13,1,19,13",10,100,99,99,"1111001110","1111101101",0
"29,22,29,19,6,16,29,11,8,23","20,15,23,14,8,23,20,15,9,18",10,100,130,134,"1101001011","1111101000",4
"2,22,17,18,21,30,1,6,1,29","1,15,17,25,21,25,1,8,1,20",10,100,122,122,"1110111001","1110110011",0
"8,21,16,19,3,15,11,18,29,6","6,18,23,17,2,16,13,25,21,8",10,100,106,109,"1101111010","1101011011",3
"2,2,26,5,26,22,6,13,8,10","1,1,20,5,20,15,8,13,6,14",10,100,110,115,"1111111110","1110111111",5
"18,8,16,17,4,5,15,25,22,6","25,11,22,17,4,5,10,23,15,11",10,100,102,106,"0101111111","1001111110",4
"2,23,29,29,6,30,29,13,2,8","2,17,23,20,7,21,20,18,2,14",10,100,121,128,"1101111010","1101011110",7
"31,8,24,6,23,16,20,12,8,30","21,14,17,8,18,12,15,17,6,25",10,100,128,132,"1011111010","1010110011",4
"21,18,25,18,14,6,4,19,29,14","18,12,23,25,25,7,3,14,20,25",10,100,122,122,"1110011110","1110011110",0
"4,7,24,8,1,29,4,8,11,16","3,7,17,11,1,22,4,9,15,23",10,100,96,103,"1111111110","1110011111",7
"20,1,15,10,14,6,14,19,16,1","15,1,16,14,25,8,15,14,22,1",10,100,92,96,"1110011111","1111001111",4
"18,21,18,21,29,14,24,12,16,5","23,18,25,21,23,25,17,17,12,5",10,100,116,116,"0101101011","0101101011",0
"31,7,19,18,5,13,14,5,24,8","21,7,17,15,5,18,10,5,16,14",10,100,123,123,"1111101110","1111101110",0
"15,9,24,14,17,6,24,6,11,29","16,6,17,25,25,7,17,5,12,21",10,100,118,118,"1110001111","1110001111",0
"8,26,10,26,6,30,2,6,21,7","14,23,14,23,11,20,2,5,21,8",10,100,111,116,"0101011110","0101010111",5
"29,1,2,11,15,12,6,4,8,8","22,1,1,13,10,11,8,3,9,13",10,100,96,96,"1111111111","1111111111",0
"9,23,8,22,2,6,29,30,8,24","6,18,8,16,1,8,21,20,6,17",10,100,132,139,"1011101111","1101101101",7
"8,17,12,22,10,8,21,3,15,9","11,17,17,16,7,14,18,2,10,6",10,100,105,110,"1101101111","1101111011",5
"2,24,17,7,12,7,18,30,2,6","1,17,17,7,17,11,23,25,1,7",10,100,106,106,"1111001111","1111001111",0
"29,29,2,3,6,8,24,29,4,18","22,20,1,2,6,9,17,20,4,15",10,100,134,136,"1111001101","1101001111",2
"2,6,11,14,2,20,5,26,5,34","1,8,12,10,1,15,3,20,3,25",10,100,125,125,"1111111111","1111111111",0
"14,24,24,1,24,14,15,3,18,13","10,16,17,1,17,10,10,2,15,19",10,100,137,137,"1111111110","1111111110",0
"6,8,1,6,2,8,8,8,20,18","8,6,1,6,1,8,13,11,15,12",10,100,85,85,"1111111111","1111111111",0
"5,9,6,21,29,16,30,31,9,7","5,6,6,21,24,15,20,21,6,8",10,100,129,131,"1100111110","0100111111",2
"10,23,8,6,21,18,29,6,6,11","7,17,6,8,18,25,20,8,7,12",10,100,114,115,"1111101011","1110111010",1
"7,33,17,13,10,4,15,16,7,14","7,24,17,18,14,3,10,15,7,10",10,100,113,116,"1110011111","0110111111",3
"8,14,1,7,8,18,8,29,24,21","13,10,1,7,6,25,11,20,17,21",10,100,112,115,"0111101111","0110110111",3
"5,16,7,8,6,11,18,16,3,4","5,12,7,9,6,13,19,23,2,4",10,100,94,94,"1111111111","1111111111",0
"30,7,6,16,29,20,26,8,18,5","25,8,5,22,23,15,23,8,15,5",10,100,116,119,"1010110111","1010111100",3
"26,29,22,17,11,10,24,8,29,18","20,23,15,17,15,14,17,9,23,19",10,100,130,130,"1110001010","1110001010",0
"4,18,12,12,11,15,34,9,11,17","4,25,11,17,15,16,25,6,12,25",10,100,96,103,"1010111110","1110011110",7
"22,6,21,11,33,7,13,6,2,18","15,8,18,13,24,8,13,8,1,12",10,100,122,122,"1110111011","1010111111",0
"17,7,16,10,18,25,7,26,18,20","17,8,15,14,19,23,8,23,23,13",10,100,111,111,"1110010101","1010011101",0
"30,10,29,5,4,24,18,4,17,2","20,14,22,3,3,17,23,4,25,1",10,100,116,118,"1011111101","1111011001",2
"29,16,16,5,23,8,16,33,8,29","22,19,21,5,18,8,22,24,9,23",10,100,127,127,"1001110101","1001110101",0
"9,12,23,16,14,5,3,15,1,6","6,11,18,23,25,3,2,10,1,7",10,100,90,98,"1111011111","1111111110",8
"1,6,8,24,16,3,14,8,26,20","1,6,9,17,15,2,10,9,20,15",10,100,118,120,"1111111011","1011111111",2
"19,22,2,22,10,13,16,2,8,1","17,15,2,16,7,18,12,2,11,1",10,100,102,114,"1111101111","1111111110",12
"14,14,15,20,30,1,29,2,29,2","15,10,16,17,25,1,20,1,20,1",10,100,127,127,"0101111111","0101111111",0
"5,29,7,8,20,13,22,7,8,11","3,22,11,8,13,13,16,7,6,12",10,100,123,123,"1101111111","1101111111",0
"3,4,16,4,21,19,4,18,11,18","2,4,23,3,21,14,3,25,15,19",10,100,84,96,"1101111011","1011111011",12
"7,2,2,11,13,22,29,2,8,2","7,2,1,15,19,15,24,2,13,1",10,100,98,98,"1111111111","1111111111",0
"10,13,8,1,16,11,18,6,3,2","14,13,13,1,15,15,15,8,2,2",10,100,88,88,"1111111111","1111111111",0
"14,24,14,24,17,8,11,3,16,7","15,16,25,16,25,13,13,2,12,7",10,100,107,109,"1101011111","1101101110",2
"31,5,33,16,6,7,29,19,1,18","21,5,24,23,7,7,23,14,1,19",10,100,125,126,"1110011110","1010111110",1
"8,18,6,8,20,8,17,22,7,16","13,23,8,9,13,14,25,16,7,22",10,100,97,97,"0111100111","0111100111",0
"14,16,16,16,29,16,8,29,6,22","25,15,12,12,22,12,6,21,8,16",10,100,123,130,"0111011101","0111111100",7
"8,14,16,11,18,19,5,11,22,8","9,25,23,13,23,17,5,12,15,13",10,100,94,94,"1001111110","0001111111",0
"23,6,18,18,34,6,18,6,22,15","18,5,23,23,25,5,19,8,15,16",10,100,115,118,"1100111110","1000111011",3
"14,24,22,16,8,34,26,8,18,2","10,17,16,21,6,25,23,6,23,1",10,100,112,130,"1110110101","1110011101",18
"4,16,6,10,34,5,29,23,2,4","4,19,8,14,25,5,21,17,1,4",10,100,117,119,"1100111111","0110111111",2
"16,18,3,6,1,17,18,6,6,30","21,19,2,5,1,17,25,7,11,25",10,100,97,98,"1111110101","0111011101",1
"1,18,24,4,31,7,13,7,14,7","1,25,17,3,21,7,13,8,15,7",10,100,108,108,"1011111111","1011111111",0
"6,29,23,18,16,19,7,4,1,20","11,23,17,15,19,14,7,4,1,17",10,100,121,121,"0111011111","0111011111",0
"30,5,13,16,1,7,23,30,13,16","20,5,13,15,1,7,18,21,19,22",10,100,125,125,"1111111100","1111111100",0
"14,11,8,13,21,23,13,16,13,30","15,13,6,19,21,18,13,23,19,21",10,100,109,109,"1010111001","1010110011",0
"18,18,2,5,18,29,17,14,5,8","12,19,1,3,12,22,25,25,5,13",10,100,112,112,"1111111010","1111111010",0
"6,29,17,13,1,16,24,16,29,8","7,23,25,13,1,22,17,15,24,13",10,100,118,118,"1101101110","1101101110",0
"7,5,8,25,29,11,1,24,8,22","8,5,13,23,24,15,1,17,8,15",10,100,114,120,"0101101111","1101100111",6
"11,16,1,1,11,3,8,4,13,6","15,12,1,1,15,2,6,3,13,5",10,100,74,74,"1111111111","1111111111",0
"12,16,6,29,18,20,23,30,13,4","17,15,11,22,23,13,18,25,19,4",10,100,122,122,"0101011101","0101011101",0
"6,6,13,5,11,18,18,29,7,16","11,8,18,5,13,23,15,23,8,12",10,100,104,104,"0001111111","0001111111",0
"1,8,1,18,26,8,29,33,11,16","1,14,1,19,23,13,22,24,12,15",10,100,117,117,"1010101111","1010101111",0
"21,23,14,4,4,31,7,8,31,7","18,17,10,3,4,21,11,9,21,7",10,100,128,132,"1111110010","1110110110",4
"22,8,14,6,16,33,6,7,7,18","15,6,10,11,22,24,5,7,7,19",10,100,115,115,"1110011111","1110011111",0
"30,20,2,2,8,8,16,21,9,5","20,13,1,1,9,6,19,21,6,5",10,100,105,119,"1111110111","1101111111",14
"30,6,8,6,30,17,26,13,11,23","21,5,8,8,20,25,23,13,12,17",10,100,123,128,"1110101001","1100101101",5
"8,31,18,5,4,19,17,1,14,9","14,21,23,5,3,14,25,1,15,6",10,100,101,105,"0111110111","1111010111",4
"10,20,29,2,5,8,6,4,16,20","7,17,20,1,3,13,5,3,23,17",10,100,112,112,"1111101111","1111101111",0
"9,8,10,7,18,22,13,18,9,29","6,14,14,7,23,16,13,19,6,22",10,100,107,112,"1001011111","1001110111",5
"2,34,14,16,18,18,29,19,17,6","1,25,10,12,12,12,21,17,25,5",10,100,137,137,"1111111001","1111111001",0
"1,10,14,16,2,8,19,6,17,21","1,14,25,22,2,6,14,8,25,21",10,100,83,90,"1101111101","1001111111",7
"21,30,7,8,16,18,8,13,12,29","21,21,7,9,21,25,9,19,17,22",10,100,103,108,"1111001001","1101001011",5
"18,2,2,1,20,20,6,18,6,22","25,1,2,1,15,13,11,25,7,16",10,100,97,103,"1111111011","1111110101",6
"21,6,2,8,16,7,14,24,2,23","21,5,1,6,19,8,10,17,1,18",10,100,107,116,"1111011111","1111101111",9
"30,20,5,2,18,1,2,11,14,11","25,13,5,2,23,1,1,15,10,15",10,100,103,103,"1111111110","1111111011",0
"18,29,31,14,14,29,26,16,24,16","12,22,21,10,25,22,20,22,17,15",10,100,132,134,"1111000011","1011011001",2
"8,8,8,18,6,18,8,18,23,1","14,14,6,23,8,25,13,19,17,1",10,100,92,92,"0011110111","0011110111",0
"26,1,8,8,10,24,24,19,12,29","23,1,6,6,14,16,17,17,11,23",10,100,120,125,"1111011001","0111011111",5
"15,29,29,11,15,3,8,4,2,14","10,20,23,12,16,2,13,4,1,25",10,100,108,114,"1111110110","1111111100",6
"8,24,18,8,11,23,18,20,4,21","6,17,25,13,13,17,19,13,4,18",10,100,118,118,"1100011111","1100011111",0
"24,6,8,29,22,31,21,7,6,4","16,6,8,22,15,21,18,11,8,4",10,100,133,135,"1101111000","1011111000",2
"1,4,12,18,18,8,3,29,18,21","1,3,17,19,25,13,2,23,12,18",10,100,106,108,"1111001111","1001101111",2
"18,6,1,13,16,16,29,16,1,24","25,8,1,18,15,22,20,22,1,17",10,100,93,104,"0110111011","1000101111",11
"2,24,8,14,6,23,6,17,14,6","1,17,9,15,7,18,5,25,15,7",10,100,103,103,"1111111011","1111111011",0
"7,2,8,30,16,4,26,10,16,7","8,2,9,25,23,3,23,7,15,11",10,100,103,106,"1111011110","1111001111",3
"24,29,21,5,10,8,18,9,29,29","16,20,21,5,7,6,25,6,24,20",10,100,138,138,"1100110111","1100110111",0
"7,6,8,5,18,10,18,15,29,6","7,5,6,3,25,7,23,16,24,5",10,100,104,104,"1111011111","1111011111",0
"26,11,21,12,2,14,1,5,7,16","20,13,21,17,2,25,1,5,11,22",10,100,89,93,"1110101111","1111100101",4
"18,2,31,4,24,21,14,8,12,18","23,1,21,3,17,21,10,13,17,15",10,100,114,120,"0111111001","0011111101",6
"29,7,14,4,23,23,18,6,29,11","23,7,10,4,17,18,15,8,21,15",10,100,129,129,"1111110010","1111110010",0
"16,20,21,2,8,5,16,19,19,34","22,17,21,1,6,3,22,17,17,25",10,100,107,118,"0101110111","0110010111",11
"18,2,8,20,20,13,11,26,16,30","25,1,11,15,17,13,13,20,15,25",10,100,114,115,"0101100111","0111010111",1
"22,8,1,26,8,25,34,26,13,16","16,6,1,23,9,23,25,20,13,12",10,100,120,125,"1110001111","1011001101",5
"14,13,24,18,18,14,23,16,15,20","10,19,17,25,12,10,18,21,16,13",10,100,128,128,"1010111011","1010111011",0
"19,9,1,16,3,6,9,19,8,24","17,6,1,12,2,7,6,14,6,16",10,100,114,114,"1111111111","1111111111",0
"16,16,26,20,23,17,19,30,8,13","19,21,20,15,18,17,14,25,9,13",10,100,118,120,"0011101100","0011100111",2
"11,18,15,9,18,21,23,5,21,16","13,25,16,6,23,21,18,5,18,15",10,100,110,110,"0011011111","0011011111",0
"2,11,29,2,22,29,26,21,4,4","1,13,20,2,15,21,20,18,3,3",10,100,129,135,"1111111011","0010111111",6
"34,18,10,8,11,13,2,6,16,13","25,15,7,13,15,19,1,8,23,19",10,100,97,99,"1110101110","1110001111",2
"17,3,22,18,23,7,24,16,16,18","25,2,16,15,17,7,16,12,19,19",10,100,113,124,"0111111100","0111101101",11
"8,15,13,6,7,23,3,8,10,29","14,10,18,8,7,18,2,14,14,23",10,100,106,106,"0111111011","0111111011",0
"30,16,3,26,6,16,26,14,1,4","25,22,2,23,8,19,23,10,1,4",10,100,110,112,"1011101111","1001011100",2
"20,33,1,7,7,16,6,22,6,12","17,24,1,7,7,12,11,16,8,17",10,100,112,117,"1111110110","1101110101",5
"1,26,16,26,16,20,16,11,5,18","1,23,23,20,22,17,19,12,3,15",10,100,107,112,"1101010111","1101011011",5
"3,14,29,10,3,8,16,13,6,16","2,10,22,14,2,13,12,13,6,19",10,100,110,110,"1111101111","1111101111",0
"21,13,13,18,3,8,16,14,14,19","21,13,19,25,2,14,21,25,10,17",10,100,94,94,"1100111011","1100111011",0
"5,7,9,2,18,23,34,6,3,33","5,11,6,1,23,18,25,8,2,24",10,100,122,122,"1111011111","1111011111",0
"5,2,30,16,21,18,16,21,8,21","5,1,20,12,18,19,22,21,13,21",10,100,116,116,"1111100101","1111100101",0
"16,18,25,1,18,2,6,26,31,9","19,15,23,1,23,1,8,23,21,6",10,100,118,118,"0111011111","0111011111",0
"17,29,3,13,30,22,8,26,22,18","17,21,2,19,20,16,11,20,16,15",10,100,132,132,"0110110110","0110110110",0
"7,8,21,22,16,14,2,4,16,2","7,6,21,15,12,15,1,4,15,2",10,100,112,112,"1111111111","1111111111",0
"6,34,14,17,26,20,30,22,16,34","6,25,10,17,20,15,25,15,22,25",10,100,130,136,"1110010101","0100110101",6
"16,2,8,4,17,2,26,21,16,8","22,2,8,4,25,1,23,21,22,6",10,100,87,93,"1111011101","1001011111",6
"19,20,18,20,14,5,5,8,30,5","14,17,23,15,10,5,5,13,21,5",10,100,118,121,"1101111011","1101101111",3
"2,6,6,16,9,11,31,30,8,16","1,6,8,22,6,13,21,21,6,12",10,100,119,119,"1110111111","1110111111",0
"14,19,30,23,16,8,23,11,20,1","10,14,21,17,15,13,17,15,17,1",10,100,130,130,"1111001011","1111001011",0
"20,16,11,16,18,17,6,16,34,6","13,15,15,15,23,17,8,22,25,5",10,100,115,115,"1101011011","1101011011",0
"6,11,7,22,20,7,1,23,12,34","8,12,7,15,15,7,1,17,11,25",10,100,126,126,"0011111111","0011111111",0
"19,29,21,18,19,8,14,18,13,22","17,22,18,12,14,6,10,23,13,16",10,100,131,131,"0111111001","0111111001",0
"3,5,16,14,5,19,16,31,14,8","2,5,19,25,3,14,19,21,25,9",10,100,103,103,"1110111101","1110111101",0
"5,7,8,8,8,10,2,19,7,8","3,8,14,13,6,14,1,14,11,13",10,100,82,82,"1111111111","1111111111",0
"8,7,14,14,34,2,16,10,19,2","14,7,15,15,25,2,12,7,17,1",10,100,112,116,"1110111111","0111101111",4
"29,26,1,16,22,16,10,20,23,12","21,20,1,23,16,19,14,13,18,11",10,100,133,133,"1110100111","1110100111",0
"18,1,8,16,13,29,29,11,16,4","12,1,8,21,19,23,22,15,21,4",10,100,105,109,"1111011001","1101011010",4
"8,2,7,6,30,24,10,17,29,8","11,1,8,11,25,17,14,25,23,13",10,100,110,110,"1110111010","1110111010",0
"2,8,16,1,20,6,24,4,11,8","1,13,15,1,13,5,16,4,13,13",10,100,100,100,"1111111111","1111111111",0
"6,8,12,21,20,17,25,7,22,13","6,11,11,18,15,17,23,8,15,18",10,100,113,117,"1011101110","0011111010",4
"18,24,11,8,4,20,23,8,19,2","23,16,12,9,3,13,18,8,14,1",10,100,119,121,"0111111111","1110111011",2
"8,30,24,1,24,24,2,30,17,8","13,21,17,1,16,17,1,20,25,6",10,100,143,143,"0111111101","0111111101",0
"5,17,25,30,21,18,18,31,30,33","5,25,23,20,21,23,23,21,25,24",10,100,129,129,"1001000111","1001000111",0
"9,29,33,22,5,26,4,18,34,17","6,20,24,16,3,20,3,15,25,17",10,100,136,136,"1111101010","0111000110",0
"20,11,22,8,15,7,11,18,16,21","17,12,15,9,10,11,15,25,15,18",10,100,113,113,"1111100011","1011101011",0
"2,18,6,6,7,8,20,18,8,18","1,19,8,7,7,13,15,25,13,25",10,100,85,89,"1111111100","1101101101",4
"8,11,16,17,10,2,9,3,8,7","13,12,22,25,14,1,6,2,8,7",10,100,83,83,"0111111111","0111111111",0
"8,18,6,24,22,30,25,8,4,11","8,12,8,17,15,20,23,11,3,12",10,100,131,131,"1101111010","1101111010",0
"8,6,18,3,6,2,14,16,6,17","11,8,12,2,6,2,10,12,6,17",10,100,96,96,"1111111111","1111111111",0
"21,18,31,6,29,1,23,8,21,6","21,12,21,8,23,1,17,6,18,7",10,100,131,131,"0110111110","0110111110",0
"22,13,17,16,24,1,4,24,5,16","15,13,17,22,17,1,4,17,3,22",10,100,110,113,"1110111110","1010111111",3
"3,29,7,30,19,18,2,13,8,16","2,21,7,25,14,23,1,13,8,15",10,100,119,120,"1111101101","1101101111",1
"11,6,16,8,18,12,29,21,7,8","13,6,23,13,23,17,21,18,8,6",10,100,100,101,"1100101111","0100111111",1
"3,6,1,16,18,2,6,8,18,6","2,7,1,21,23,1,8,13,12,7",10,100,84,84,"1111111111","1111111111",0
"8,15,2,16,18,16,14,4,29,30","13,10,1,21,25,15,10,4,23,20",10,100,118,122,"1110011111","0111011011",4
"29,29,30,16,18,17,26,8,13,17","21,22,25,15,25,17,23,9,18,25",10,100,122,122,"1110001100","1110001100",0
"30,14,1,6,29,11,16,2,16,17","21,25,1,5,24,15,15,1,15,17",10,100,117,117,"1011101111","1011101111",0
"5,16,24,19,8,19,15,18,10,30","3,23,16,17,14,17,10,25,14,20",10,100,122,122,"1011011011","1011011011",0
"18,8,18,18,18,8,2,1,30,17","12,6,19,23,23,11,1,1,25,17",10,100,102,104,"1110011111","1010101111",2
"18,7,8,10,23,30,4,16,8,22","23,7,9,14,18,25,4,22,8,15",10,100,112,112,"0111111011","0111111011",0
"17,11,29,33,33,29,16,29,16,8","25,12,24,24,24,21,19,20,15,11",10,100,132,132,"0001110101","0001110101",0
"16,7,26,6,10,2,21,1,1,2","21,11,23,8,7,1,18,1,1,1",10,100,92,92,"1111111111","1111111111",0
"29,4,11,10,7,8,34,20,16,4","21,4,13,7,7,8,25,13,22,3",10,100,116,123,"1101111101","1011111101",7
"22,2,12,10,14,14,29,8,20,20","15,2,17,14,10,10,21,9,13,17",10,100,129,129,"1100111111","1100111111",0
"3,18,22,24,30,24,16,13,2,3","2,23,15,17,20,16,22,19,1,2",10,100,126,126,"1111110011","1111110011",0
"29,29,9,10,18,12,18,16,18,10","24,21,6,7,23,11,23,22,12,7",10,100,117,123,"1111010011","1111001011",6
"2,7,2,23,23,4,16,13,12,21","1,7,1,17,18,3,15,18,17,18",10,100,111,111,"1111111101","1111111101",0
"5,3,29,31,1,29,14,16,24,29","5,2,21,21,1,23,10,22,17,22",10,100,136,136,"1111101011","1111101011",0
"26,26,8,18,8,8,15,8,31,6","20,23,13,23,11,6,16,9,21,6",10,100,112,115,"1100011011","1101010011",3
"2,16,8,8,8,16,24,8,29,29","1,22,13,13,14,22,17,11,23,22",10,100,108,108,"1100001111","1000011111",0
"13,24,16,6,15,17,16,16,8,24","13,16,15,11,16,17,23,15,14,16",10,100,110,112,"1110010101","0110110101",2
"7,20,24,16,24,13,29,11,11,8","8,15,16,22,17,19,24,12,15,9",10,100,116,119,"0110101101","0110101110",3
"18,23,2,8,30,6,8,19,26,8","25,17,1,13,20,6,6,17,23,9",10,100,122,122,"0110111111","0110111111",0
"22,22,14,13,6,30,14,4,24,17","16,16,25,13,8,21,15,4,17,25",10,100,121,125,"1101110110","1101011010",4
"9,20,6,15,7,4,8,30,13,18","6,15,5,16,8,4,13,25,13,23",10,100,104,107,"1111110110","1110110111",3
"16,7,33,6,8,7,4,19,18,26","21,11,24,8,6,7,4,17,12,23",10,100,115,118,"0010111111","0110110111",3
"8,4,23,24,11,21,6,21,11,15","9,4,18,16,12,21,7,21,12,10",10,100,116,116,"1111010101","1111010101",0
"21,12,5,11,5,15,23,19,4,29","21,17,3,13,5,16,17,17,4,21",10,100,106,117,"1010101111","1010111101",11
"19,1,21,24,7,6,16,2,1,7","17,1,18,17,7,8,22,1,1,8",10,100,104,104,"1111111111","1111111111",0
"5,4,4,6,18,6,15,13,16,18","5,4,4,7,19,11,10,13,19,25",10,100,87,93,"1111111110","1110101111",6
"11,21,29,10,29,16,30,7,29,10","13,21,20,7,21,22,20,7,20,7",10,100,137,137,"0011101011","0011101011",0
"19,2,19,20,26,5,4,16,16,10","14,1,17,13,20,3,3,22,15,7",10,100,121,121,"1111111011","1111111011",0
"6,16,16,11,22,6,13,16,8,7","8,22,22,15,15,8,18,23,6,7",10,100,89,89,"1101111011","1001111111",0
"23,24,13,25,6,11,18,16,1,18","18,17,18,23,7,13,25,15,1,23",10,100,106,108,"1101110110","1111100110",2
"6,7,20,16,6,14,12,7,20,29","8,7,13,19,6,10,17,7,15,20",10,100,119,119,"0111110111","0111110111",0
"29,29,16,8,6,14,13,18,8,13","22,24,22,14,6,25,13,19,13,19",10,100,103,105,"1100101110","1110001100",2
"3,3,8,30,33,2,7,20,13,7","2,2,11,20,24,1,11,15,19,11",10,100,112,113,"1111110110","1111111101",1
"19,8,7,1,26,17,6,18,24,11","14,6,7,1,20,25,11,19,17,12",10,100,114,114,"1111100111","1111100111",0
"18,16,15,10,6,16,16,2,25,16","23,15,10,14,5,22,15,1,23,22",10,100,98,100,"1110101110","0111001111",2
"7,16,3,10,16,1,10,14,29,19","8,15,2,7,23,1,14,25,21,14",10,100,95,104,"1111011011","0111111011",9
"1,1,6,6,7,6,20,5,1,12","1,1,11,5,7,7,17,5,1,11",10,100,65,65,"1111111111","1111111111",0
"6,23,29,4,12,15,14,5,1,13","11,18,22,3,17,10,10,5,1,18",10,100,110,111,"1111011111","0111111011",1
"18,7,29,5,4,3,14,26,20,8","23,7,20,5,4,2,15,23,17,13",10,100,108,110,"0111111110","1010011110",2
"29,19,2,4,8,7,20,8,16,16","22,14,1,3,13,7,15,9,19,22",10,100,105,109,"1111011110","1110011011",4
"3,3,8,2,14,29,9,1,18,2","2,2,9,1,25,22,6,1,19,1",10,100,89,89,"1111111111","1111111111",0
"10,16,17,18,24,30,31,13,29,8","14,21,17,15,17,25,21,13,22,9",10,100,132,132,"0001111010","0001111010",0
"13,2,29,2,14,24,8,31,4,16","18,1,24,1,25,16,8,21,3,22",10,100,116,116,"0111011111","0111011111",0
"31,30,18,2,13,18,13,2,17,2","21,21,25,1,19,23,18,2,25,1",10,100,98,103,"1101011101","1111010101",5
"20,8,24,8,16,9,12,10,7,6","15,13,17,14,12,6,11,7,7,8",10,100,112,112,"1110111111","1011111111",0
"11,29,8,8,13,14,7,18,8,30","13,24,13,14,18,25,7,12,6,20",10,100,116,116,"1100101111","1100101111",0
"29,14,16,24,29,18,18,6,23,18","24,15,15,16,24,23,25,5,17,19",10,100,111,123,"1001100110","1001100011",12
"3,18,8,4,18,34,33,9,4,24","2,15,9,4,25,25,24,6,3,17",10,100,129,130,"1101011111","0110011111",1
"26,12,7,11,18,19,7,4,7,26","20,17,7,15,15,14,11,4,7,20",10,100,114,115,"1010111111","1110110011",1
"25,1,16,15,16,2,10,24,29,4","23,1,19,10,22,2,7,17,21,3",10,100,110,123,"1101011111","1011001111",13
"16,24,6,1,18,22,8,11,19,5","19,16,8,1,15,15,6,13,14,3",10,100,114,119,"0111111111","1111111011",5
"19,11,8,14,3,18,26,18,29,18","17,15,14,10,2,19,20,23,23,19",10,100,109,113,"1001111010","1000111011",4
"2,1,30,8,18,11,16,4,16,31","1,1,20,8,15,13,15,4,12,21",10,100,126,126,"1111101111","0010111111",0
"8,18,6,19,19,22,26,8,1,29","11,12,8,17,17,15,20,13,1,23",10,100,121,123,"0111011011","1100111011",2
"20,29,18,16,14,1,12,16,7,14","13,20,23,15,25,1,11,19,8,10",10,100,115,116,"1101011111","1111001011",1
"6,9,11,21,21,29,15,16,14,3","8,6,13,18,18,22,10,23,10,2",10,100,123,123,"0111111011","0111111011",0
"3,2,30,7,4,7,2,12,14,2","2,1,25,7,3,11,1,11,25,2",10,100,83,83,"1111111111","1111111111",0
"4,21,8,2,6,4,8,30,19,16","3,21,6,2,11,4,11,21,17,15",10,100,112,112,"1111011111","1111011111",0
"6,16,8,13,2,2,20,30,8,29","11,22,13,19,1,1,15,20,14,23",10,100,107,110,"0110111101","0101011101",3
"1,11,29,10,6,12,15,16,2,16","1,13,20,7,11,17,10,23,1,15",10,100,102,105,"1111111011","0111101111",3
"23,24,2,26,24,30,20,13,33,6","18,17,1,23,16,25,15,18,24,8",10,100,132,134,"1110101011","1100110010",2
"8,13,31,30,8,13,14,1,2,3","6,18,21,25,13,18,15,1,2,2",10,100,102,107,"1111001111","1011111001",5
"24,6,16,29,6,24,17,7,8,21","17,8,22,24,11,16,17,8,6,18",10,100,123,123,"1001011011","1001011011",0
"12,8,30,8,11,8,34,26,4,2","11,14,20,9,12,14,25,20,3,1",10,100,119,125,"1010101111","1011101110",6
"8,5,3,14,1,10,20,9,18,7","6,5,2,25,1,14,17,6,25,7",10,100,81,87,"1110111111","1111011110",6
"19,31,6,7,16,14,14,25,18,4","14,21,5,7,22,10,10,23,19,3",10,100,120,125,"1111011101","1100011111",5
"26,18,8,2,18,18,6,6,16,15","20,23,11,1,12,25,8,8,22,16",10,100,99,99,"1111101101","1111101101",0
"4,26,31,8,8,6,19,8,22,29","3,20,21,8,14,8,14,6,15,23",10,100,124,135,"1111011110","0110001111",11
"16,4,20,30,18,14,8,12,12,16","22,3,13,21,12,15,11,11,17,15",10,100,114,118,"0111110101","0011111101",4
"22,30,20,16,10,16,25,25,16,24","16,20,15,12,14,12,23,23,21,17",10,100,128,133,"1111010001","1101010101",5
"18,29,16,14,7,29,6,5,12,5","23,22,15,10,11,24,8,5,17,5",10,100,111,111,"0111111101","0111111101",0
"11,6,9,20,14,16,16,24,11,8","12,8,6,15,10,23,12,16,15,14",10,100,111,113,"1111101110","1011101111",2
"15,5,16,4,16,23,17,13,30,6","16,3,22,4,12,18,17,13,25,5",10,100,114,116,"0101111111","1101111011",2
"6,18,6,13,1,24,7,7,8,3","11,23,8,13,1,16,8,7,6,2",10,100,93,93,"1111111111","1111111111",0
"15,16,1,4,11,30,14,31,23,2","16,22,1,4,13,25,25,21,18,2",10,100,117,117,"1011110111","1011110111",0
"8,5,29,6,16,30,24,18,8,18","8,5,24,8,22,21,16,25,6,15",10,100,122,123,"1110011011","1011011011",1
"1,18,16,18,12,11,8,24,18,18","1,15,23,15,17,13,8,17,25,15",10,100,98,109,"1101011101","0101111101",11
"17,7,24,20,7,19,10,34,6,34","25,8,17,15,7,17,14,25,8,25",10,100,131,131,"0011010101","0011010101",0
"29,10,21,1,18,26,30,20,1,6","20,14,18,1,23,23,20,13,1,8",10,100,128,128,"1011011110","1011011110",0
"3,8,18,33,4,8,6,8,6,8","2,11,25,24,3,13,5,8,6,11",10,100,94,94,"1111101111","1011111111",0
"7,4,16,18,18,12,16,8,2,21","11,3,15,15,15,11,21,9,1,21",10,100,99,104,"0111110111","1111110101",5
"12,18,10,30,24,3,2,34,29,13","17,15,7,21,17,2,1,25,21,18",10,100,132,137,"0011111110","0101101110",5
"20,1,30,12,23,21,24,6,8,2","13,1,25,17,18,21,17,11,14,1",10,100,121,121,"1110111001","1110111001",0
"29,7,8,19,26,6,34,5,6,14","23,7,11,17,20,8,25,5,7,10",10,100,127,127,"1001101101","1001101101",0
"21,30,4,16,24,10,6,2,6,15","18,20,3,15,17,14,8,1,8,16",10,100,118,118,"1111101101","1111100111",0
"16,16,24,16,12,10,8,34,25,4","21,15,17,19,11,7,14,25,23,4",10,100,121,121,"0110110110","0110110110",0
"8,26,24,22,22,5,1,26,1,3","13,20,17,15,16,5,1,20,1,2",10,100,130,130,"0111111111","0111111111",0
"16,20,2,4,15,16,10,21,2,18","21,13,1,4,10,22,14,21,2,15",10,100,98,106,"1111100111","1101101111",8
"8,7,29,23,8,1,6,7,12,29","8,7,22,17,9,1,7,8,11,24",10,100,117,117,"1111110011","1011110111",0
"30,15,26,4,1,4,16,6,8,7","25,10,20,3,1,4,21,8,14,7",10,100,109,109,"1111111101","1111111101",0
"16,8,12,29,16,8,8,22,8,15","23,6,17,20,19,13,13,15,13,16",10,100,102,106,"0111100101","1101100101",4
"20,2,18,11,26,17,18,8,14,20","15,1,15,13,20,25,12,9,15,17",10,100,118,118,"1110101011","1110101011",0
"26,19,18,7,23,6,21,14,4,6","20,14,23,11,17,8,18,25,4,8",10,100,111,113,"1110101010","1110101001",2
"18,12,23,5,12,16,7,7,3,25","25,17,18,3,11,15,7,7,2,23",10,100,98,105,"0011111111","0110111111",7
"16,5,8,25,33,21,18,1,10,19","15,5,8,23,24,21,25,1,14,17",10,100,107,114,"1111100101","1001110001",7
"4,5,31,16,29,6,2,19,18,18","4,3,21,12,24,7,1,17,25,23",10,100,112,118,"1111111100","0111100101",6
"23,26,4,11,2,29,13,16,18,8","18,23,4,13,1,21,19,22,23,13",10,100,108,109,"1111111000","1101110010",1
"11,26,10,11,18,12,30,21,2,4","15,23,7,15,25,11,25,18,1,3",10,100,105,112,"0110011111","0111011110",7
"30,2,24,5,13,7,26,29,16,13","20,1,17,5,19,7,20,22,23,13",10,100,123,131,"1111011100","1110011101",8
"8,26,11,30,33,29,30,2,24,7","11,20,13,21,24,23,25,1,17,7",10,100,122,129,"0101100111","0001111001",7
"11,17,1,29,8,2,10,14,29,23","13,25,1,24,14,2,14,10,20,18",10,100,109,117,"1011010111","1011001111",8
"16,29,20,22,18,33,6,11,2,21","22,23,13,16,19,24,8,12,1,21",10,100,127,127,"0111010011","0111010011",0
"23,8,1,14,20,24,14,24,18,5","18,11,1,10,15,17,10,16,19,5",10,100,125,128,"1011111101","1000111111",3
"24,18,1,6,5,1,1,24,11,11","16,25,1,8,3,1,1,17,12,12",10,100,102,102,"1111111111","1111111111",0
"8,29,6,20,24,18,14,6,18,16","14,21,8,13,17,25,10,6,23,21",10,100,117,117,"0111101110","0111101110",0
"2,23,16,11,23,24,20,18,15,18","1,18,12,13,18,16,17,19,16,25",10,100,123,124,"1110111010","0110111100",1
"8,8,18,2,33,24,18,6,19,2","13,13,23,2,24,17,23,8,17,2",10,100,104,106,"0011110111","0101111011",2
"16,26,5,20,18,18,2,16,5,6","12,23,3,15,25,12,2,22,3,8",10,100,114,114,"1111011111","1111011111",0
"4,2,5,11,23,8,4,1,14,24","4,1,5,13,17,6,3,1,10,17",10,100,96,96,"1111111111","1111111111",0
"13,3,6,2,16,8,1,5,14,8","13,2,7,1,15,6,1,5,10,8",10,100,76,76,"1111111111","1111111111",0
"21,16,24,18,18,34,23,20,29,1","18,12,17,25,23,25,17,15,22,1",10,100,118,132,"0110011101","1010011011",14
"15,2,34,8,7,25,17,14,29,18","10,1,25,13,8,23,25,15,21,12",10,100,130,130,"1110110011","1110110011",0
"14,5,24,13,31,26,2,2,14,22","10,5,16,13,21,23,1,1,25,15",10,100,126,134,"1110111101","1011111101",8
"16,1,14,5,14,29,11,3,6,6","22,1,10,3,10,21,13,2,11,8",10,100,99,104,"1111111101","1011111111",5
"22,2,2,3,18,10,18,2,2,30","16,1,1,2,19,7,25,1,1,25",10,100,109,109,"1111111111","1111111111",0
"17,13,16,6,14,2,16,11,6,16","25,19,19,8,10,1,12,12,6,21",10,100,87,94,"0011111111","0110111111",7
"2,16,5,18,3,25,33,14,15,13","1,23,5,25,2,23,24,10,16,19",10,100,110,110,"1010111111","1010111111",0
"14,2,16,7,12,29,24,29,29,19","25,1,19,7,11,22,17,23,21,14",10,100,132,132,"0100011111","0100011111",0
"16,2,15,13,1,7,14,13,25,25","15,1,10,19,1,11,10,19,23,23",10,100,105,108,"1110111011","1010001111",3
"16,24,6,11,16,26,18,29,29,12","22,17,5,13,21,23,19,24,22,11",10,100,114,120,"0110010110","0100010111",6
"17,16,21,4,16,5,16,8,29,8","17,22,21,3,12,3,21,6,23,14",10,100,108,108,"1011110111","1011110111",0
"7,24,4,8,20,6,22,8,3,6","7,17,3,11,17,8,15,6,2,8",10,100,108,108,"1111111111","1111111111",0
"25,30,16,13,7,6,30,34,13,19","23,25,22,19,7,11,25,25,13,17",10,100,120,120,"0100101101","0100101101",0
"15,3,2,34,33,7,26,15,18,30","10,2,1,25,24,7,20,10,12,21",10,100,142,142,"1110101111","1110101111",0
"21,26,11,33,16,17,30,34,18,14","21,23,12,24,15,25,25,25,25,25",10,100,123,123,"0101001100","0101001100",0
"14,30,19,7,1,7,2,30,29,13","25,25,17,7,1,8,1,21,24,19",10,100,118,118,"0111101110","0110111110",0
"11,4,23,16,16,13,16,9,5,6","12,3,17,22,15,18,23,6,3,8",10,100,90,97,"1111100111","1110111110",7
"14,16,16,12,34,20,29,8,10,8","10,15,22,17,25,13,20,14,14,6",10,100,121,125,"1100111001","1101111000",4
"8,6,18,22,34,16,7,18,8,23","8,6,25,16,25,23,8,25,8,17",10,100,108,113,"1101101011","1001100111",5
"24,10,6,13,4,14,6,20,5,16","16,14,11,13,4,10,6,13,5,22",10,100,108,108,"1011111111","1011111111",0
"6,13,22,16,4,20,6,33,7,8","8,19,15,15,3,13,6,24,7,9",10,100,122,122,"1011111111","1011111111",0
"10,11,13,16,1,15,34,6,18,18","7,15,19,19,1,16,25,5,12,25",10,100,111,111,"1101111110","1101111110",0
"6,16,7,12,8,6,6,15,8,26","5,22,7,17,14,7,8,10,8,23",10,100,90,96,"1110011111","1111001111",6
"21,8,13,8,18,6,15,7,2,18","21,6,13,13,12,8,16,11,2,25",10,100,90,96,"1110111110","1111111100",6
"16,10,1,6,29,6,14,6,18,22","15,14,1,11,24,5,10,6,19,16",10,100,112,112,"1010111111","1010111111",0
"31,7,31,22,29,3,22,6,20,17","21,7,21,15,24,2,16,8,17,17",10,100,138,138,"1011111000","1011111000",0
"1,6,8,26,1,19,24,6,15,7","1,8,13,23,1,17,17,8,16,7",10,100,105,105,"1101111111","1101111111",0
"6,29,8,14,2,26,1,12,23,16","8,24,13,25,1,20,1,11,17,19",10,100,109,114,"0100111111","1100110111",5
"18,11,34,6,15,16,18,18,7,4","25,13,25,11,16,15,25,19,11,4",10,100,98,101,"0110110101","0110110110",3
"13,1,8,23,3,8,9,5,7,5","13,1,13,17,2,14,6,5,7,5",10,100,82,82,"1111111111","1111111111",0
"33,2,25,12,14,6,1,7,6,2","24,1,23,11,10,6,1,8,8,1",10,100,108,108,"1111111111","1111111111",0
"2,19,14,7,7,12,4,8,7,7","1,17,15,11,7,17,4,6,11,11",10,100,87,87,"1111111111","1111111111",0
"16,26,21,12,1,5,30,4,29,31","15,20,21,17,1,3,21,3,21,21",10,100,126,133,"0100111111","1100101011",7
"10,2,2,22,19,8,12,29,30,7","14,1,1,16,17,11,11,23,21,7",10,100,123,123,"0111101111","0111101111",0
"20,18,30,16,18,4,2,3,30,14","13,19,21,23,23,3,1,2,21,10",10,100,121,121,"1110011111","1010111111",0
"18,18,6,2,3,20,5,6,21,30","25,23,6,1,2,13,5,5,18,20",10,100,111,111,"0111111111","0111111111",0
"10,22,16,22,24,15,6,8,14,8","14,15,12,16,17,16,11,6,10,9",10,100,121,124,"0111110110","1111100111",3
"1,16,5,19,13,2,18,10,25,7","1,15,5,17,18,1,23,7,23,7",10,100,103,103,"1111011111","1111011111",0
"6,3,10,14,16,17,18,9,3,4","8,2,14,10,22,25,25,6,2,3",10,100,83,86,"1111101111","1101111110",3
"19,19,8,6,29,20,29,8,4,30","14,17,9,8,23,17,22,9,3,20",10,100,131,131,"1000111011","1000111011",0
"18,6,30,18,1,2,8,13,29,4","23,8,25,12,1,1,9,18,23,4",10,100,110,110,"1011111011","0111011111",0
"2,14,4,7,8,2,2,18,3,6","2,15,3,11,11,1,1,25,2,6",10,100,66,66,"1111111111","1111111111",0
"21,7,5,3,7,18,14,4,21,7","21,7,5,2,11,23,25,4,18,7",10,100,93,93,"1111110111","1111110111",0
"2,11,1,7,20,29,30,29,8,13","1,15,1,7,17,21,20,23,11,19",10,100,118,125,"1011111100","1001111110",7
"6,2,17,1,16,2,19,29,1,16","8,1,17,1,23,1,17,20,1,19",10,100,93,103,"1111011111","0111111111",10
"6,16,19,16,17,8,20,16,19,15","6,21,14,12,25,8,15,15,17,16",10,100,104,113,"1011011110","0011011111",9
"6,5,7,2,6,29,18,7,2,18","7,5,7,1,6,24,23,7,1,12",10,100,100,100,"1111111111","1111111111",0
"21,8,24,5,14,16,2,17,6,6","21,14,16,3,25,15,2,17,8,8",10,100,97,99,"1011011111","1111011101",2
"1,8,4,22,29,15,16,18,8,16","1,9,4,16,22,16,23,15,11,22",10,100,105,108,"1111110110","0101110101",3
"1,16,17,1,4,14,9,21,1,15","1,22,25,1,3,15,6,21,1,16",10,100,82,85,"1101111111","1111101111",3
"16,5,26,11,20,30,12,14,14,14","22,5,20,13,15,21,17,10,10,15",10,100,123,123,"0110110111","0110110111",0
"7,26,15,8,4,22,1,12,9,30","7,23,16,6,3,15,1,17,6,25",10,100,107,118,"1101111011","1111011011",11
"7,14,4,8,16,10,13,13,7,13","7,25,3,13,22,7,18,19,7,13",10,100,83,83,"1010111111","1010111111",0
"16,18,29,22,6,8,18,26,29,6","21,23,23,16,8,14,15,20,24,8",10,100,124,124,"0011001110","0011001110",0
"20,6,13,7,6,16,21,10,16,24","17,6,19,7,8,23,21,7,15,16",10,100,110,110,"1101101111","1101101111",0
"6,4,6,16,1,7,4,16,25,10","7,4,11,23,1,11,3,22,23,14",10,100,82,82,"1101101111","0101011111",0
"10,8,26,5,33,11,6,1,29,10","7,6,20,3,24,13,8,1,23,7",10,100,128,128,"1111101111","1111101111",0
"23,12,6,16,3,29,10,18,19,33","18,17,11,12,2,23,7,15,17,24",10,100,120,129,"1011111001","1001011101",9
"19,18,15,7,2,21,7,30,13,34","17,19,10,8,1,21,11,21,13,25",10,100,121,123,"1010110101","1111000101",2
"5,30,14,7,18,18,6,30,13,30","3,21,15,7,15,15,8,20,13,25",10,100,131,131,"1100110101","1100110101",0
"29,2,24,18,29,22,18,22,12,16","21,1,16,25,23,16,25,16,11,21",10,100,128,128,"1110110100","1110110100",0
"18,24,8,29,7,29,18,20,8,22","25,17,6,24,8,24,19,13,13,15",10,100,132,132,"0111010101","0111010101",0
"6,13,5,21,16,8,17,6,7,6","8,18,5,18,23,6,17,5,8,8",10,100,89,93,"1111011111","0111111110",4
"11,3,8,9,13,6,2,8,10,7","15,2,13,6,19,11,1,8,14,11",10,100,77,77,"1111111111","1111111111",0
"6,23,2,15,24,10,18,14,7,7","6,17,1,16,17,14,12,15,8,11",10,100,109,113,"1111101110","0111111110",4
"11,16,13,15,18,16,13,17,22,21","13,15,13,10,23,15,18,25,15,18",10,100,114,114,"1111010011","1111010011",0
"34,12,13,6,21,8,24,16,26,8","25,17,19,11,18,13,17,19,20,13",10,100,121,121,"1000101110","1000101110",0
"13,29,16,11,31,12,6,8,4,20","19,21,19,13,21,17,5,14,4,17",10,100,117,117,"0111101011","0111101011",0
"23,16,6,20,29,2,8,26,8,21","18,23,5,13,20,1,6,20,6,18",10,100,122,133,"1011111110","1011100111",11
"16,5,6,8,29,2,31,15,29,2","22,5,5,14,20,1,21,16,22,1",10,100,119,122,"0110111111","0011111111",3
"15,16,22,2,14,29,7,4,8,21","10,12,16,1,10,20,7,4,11,18",10,100,130,130,"1111111101","1111111101",0
"15,23,16,8,11,6,6,29,19,14","10,17,22,11,13,7,8,23,17,25",10,100,109,111,"1100111110","1101101110",2
"18,6,19,12,33,11,8,21,6,8","19,8,14,17,24,12,6,18,8,11",10,100,110,113,"1010111100","1010101111",3
"21,6,9,14,20,16,2,18,13,9","21,7,6,15,17,15,1,15,18,6",10,100,109,109,"1011111101","1011111101",0
"15,24,15,8,21,1,20,14,4,30","16,17,10,8,21,1,15,10,4,25",10,100,116,125,"0111011111","0110111101",9
"16,8,19,22,13,15,24,22,34,6","22,6,17,16,18,16,17,16,25,8",10,100,129,129,"0111001110","0111001110",0
"8,2,18,24,8,18,8,8,6,8","8,1,25,17,6,19,13,11,8,6",10,100,90,98,"1101111111","1011110111",8
"3,13,1,8,17,13,14,20,16,8","2,13,1,14,25,18,10,17,22,8",10,100,88,92,"1110011111","1110101111",4
"6,17,11,18,7,16,8,16,3,16","8,25,15,25,7,12,13,23,2,22",10,100,77,82,"1011110011","1001110111",5
"21,20,8,12,15,12,21,16,22,17","21,17,9,17,16,17,18,22,16,25",10,100,107,107,"1110101010","1110101010",0
"18,8,2,26,16,4,15,14,3,23","12,14,1,23,21,3,16,25,2,18",10,100,107,107,"1011111011","1011111011",0
"34,11,34,1,1,18,6,11,18,30","25,15,25,1,1,25,11,13,25,20",10,100,122,122,"1111100101","1111100101",0
"16,14,14,6,6,13,18,4,2,20","22,15,10,8,6,18,23,4,1,17",10,100,84,94,"0111101111","1110101111",10
"6,17,14,5,7,25,20,8,13,20","7,17,10,5,8,23,17,6,13,15",10,100,115,115,"1111011101","1111011101",0
"1,19,6,29,18,7,20,16,18,33","1,17,7,24,12,7,15,22,12,24",10,100,126,127,"1001111011","1101011011",1
"16,7,23,11,20,22,18,21,18,20","12,7,17,15,17,15,23,18,23,13",10,100,129,129,"1110110101","1110110101",0
"14,12,18,14,3,12,31,20,7,16","10,17,23,10,2,11,21,13,7,15",10,100,117,122,"1001111111","1101111101",5
"18,8,4,15,7,6,17,15,29,23","23,9,3,10,7,5,17,16,23,17",10,100,116,117,"0011111111","0111011111",1
"1,17,3,19,1,5,10,18,12,2","1,17,2,14,1,5,7,23,11,2",10,100,88,88,"1111111111","1111111111",0
"8,24,29,14,2,13,22,6,22,16","13,17,22,10,1,19,15,8,16,15",10,100,129,129,"0111101011","0111101011",0
"24,16,16,23,8,31,2,6,4,2","16,22,15,18,11,21,1,8,3,2",10,100,116,118,"1011111111","1111011011",2
"15,16,17,2,23,8,11,4,30,29","16,23,17,1,18,6,13,3,21,22",10,100,113,122,"0011110111","1001111111",9
"4,26,18,2,30,11,18,6,18,29","4,23,23,2,20,13,19,7,25,23",10,100,115,116,"1101101101","0101111001",1
"21,23,20,14,3,16,22,30,20,14","21,17,13,25,2,23,16,20,13,10",10,100,132,136,"0110101111","1110001110",4
"10,4,7,13,6,20,20,19,26,19","14,3,7,18,5,13,17,17,20,14",10,100,121,121,"0110111111","0110111111",0
"3,8,13,16,6,24,29,20,7,8","2,8,13,15,6,17,23,15,7,8",10,100,119,120,"1111111100","1011011111",1
"5,20,1,6,9,19,29,13,12,6","3,15,1,8,6,17,22,18,17,5",10,100,108,108,"1111111101","0100111111",0
"24,21,6,24,6,16,6,8,29,1","16,18,8,17,7,19,8,13,22,1",10,100,121,121,"1101110011","1101110011",0
"29,18,29,24,8,1,22,4,16,2","21,23,22,17,13,1,15,4,19,1",10,100,127,127,"1011011111","1011011111",0
"7,16,2,29,2,7,18,29,18,7","7,15,1,20,1,7,23,20,25,7",10,100,99,115,"1111110101","1101111101",16
"13,18,18,2,15,1,33,26,8,7","19,23,25,1,16,1,24,23,13,7",10,100,102,102,"0101111101","0011111101",0
"2,10,14,22,14,6,33,24,29,12","1,14,10,16,15,5,24,17,22,17",10,100,130,130,"1011011110","1001111110",0
"31,1,7,21,11,7,12,15,8,16","21,1,7,21,12,7,17,10,6,22",10,100,101,110,"1111110110","1101110111",9
"22,8,22,13,2,24,17,7,6,23","15,8,15,13,1,17,17,7,7,18",10,100,121,125,"1111110101","1111010111",4
"24,8,6,16,21,2,8,16,21,26","17,14,8,23,21,1,11,22,18,23",10,100,108,108,"1010111011","1010111011",0
